SNo,Date,Country,RegionCode,RegionName,Latitude,Longitude,HospitalizedPatients,IntensiveCarePatients,TotalHospitalizedPatients,HomeConfinement,CurrentPositiveCases,NewPositiveCases,Recovered,Deaths,TotalPositiveCases,TestsPerformed
3990,2020-09-01T17:00:00,ITA,13,Abruzzo,42.35122196,13.39843823,29,1,30,376,406,5,2902,472,3780,102588
3991,2020-09-01T17:00:00,ITA,17,Basilicata,40.63947052,15.80514834,1,1,2,86,88,1,408,28,524,55949
3992,2020-09-01T17:00:00,ITA,18,Calabria,38.90597598,16.59440194,22,0,22,244,266,22,1150,97,1513,155296
3993,2020-09-01T17:00:00,ITA,15,Campania,40.83956555,14.25084984,143,6,149,2143,2292,102,4430,446,7168,242683
3994,2020-09-01T17:00:00,ITA,8,Emilia-Romagna,44.49436681,11.3417208,106,9,115,2946,3061,99,24497,4463,32021,533273
3995,2020-09-01T17:00:00,ITA,6,Friuli Venezia Giulia,45.6494354,13.76813649,12,2,14,363,377,17,3061,348,3786,153624
3996,2020-09-01T17:00:00,ITA,12,Lazio,41.89277044,12.48366722,336,8,344,2941,3285,125,7153,878,11316,486744
3997,2020-09-01T17:00:00,ITA,7,Liguria,44.41149315,8.9326992,39,5,44,516,560,19,8839,1571,10970,128951
3998,2020-09-01T17:00:00,ITA,3,Lombardia,45.46679409,9.190347404,212,21,233,6849,7082,242,76368,16867,100317,986403
3999,2020-09-01T17:00:00,ITA,11,Marche,43.61675973,13.5188753,14,1,15,294,309,16,5960,987,7256,122724
4000,2020-09-01T17:00:00,ITA,14,Molise,41.55774754,14.65916051,3,0,3,70,73,3,432,23,528,32507
4001,2020-09-01T17:00:00,ITA,21,P.A. Bolzano,46.49933453,11.35662422,8,2,10,191,201,13,2455,292,2948,73432
4002,2020-09-01T17:00:00,ITA,22,P.A. Trento,46.06893511,11.12123097,4,1,5,87,92,3,4602,405,5099,83419
4003,2020-09-01T17:00:00,ITA,1,Piemonte,45.0732745,7.680687483,92,7,99,1365,1464,42,27313,4146,32923,363196
4004,2020-09-01T17:00:00,ITA,16,Puglia,41.12559576,16.86736689,123,7,130,730,860,39,4062,557,5479,218643
4005,2020-09-01T17:00:00,ITA,20,Sardegna,39.21531192,9.110616306,31,6,37,800,837,50,1272,134,2243,116718
4006,2020-09-01T17:00:00,ITA,19,Sicilia,38.11569725,13.3623567,71,10,81,1071,1152,33,2911,287,4350,269806
4007,2020-09-01T17:00:00,ITA,9,Toscana,43.76923077,11.25588885,53,9,62,1519,1581,40,9175,1142,11898,360022
4008,2020-09-01T17:00:00,ITA,10,Umbria,43.10675841,12.38824698,9,2,11,267,278,10,1445,80,1803,96713
4009,2020-09-01T17:00:00,ITA,2,Valle d'Aosta,45.73750286,7.320149366,3,0,3,27,30,0,1065,146,1241,17699
4010,2020-09-01T17:00:00,ITA,5,Veneto,45.43490485,12.33845213,69,9,78,2382,2460,97,18444,2122,23026,614376
4011,2020-09-02T17:00:00,ITA,13,Abruzzo,42.35122196,13.39843823,30,1,31,399,430,24,2902,472,3804,103603
4012,2020-09-02T17:00:00,ITA,17,Basilicata,40.63947052,15.80514834,1,1,2,88,90,2,408,28,526,56534
4013,2020-09-02T17:00:00,ITA,18,Calabria,38.90597598,16.59440194,21,0,21,269,290,32,1158,97,1545,157068
4014,2020-09-02T17:00:00,ITA,15,Campania,40.83956555,14.25084984,163,4,167,2235,2402,117,4437,446,7285,247341
4015,2020-09-02T17:00:00,ITA,8,Emilia-Romagna,44.49436681,11.3417208,104,10,114,2989,3103,107,24562,4463,32128,540012
4016,2020-09-02T17:00:00,ITA,6,Friuli Venezia Giulia,45.6494354,13.76813649,11,3,14,373,387,20,3070,349,3806,154882
4017,2020-09-02T17:00:00,ITA,12,Lazio,41.89277044,12.48366722,343,9,352,3055,3407,130,7161,878,11446,495791
4018,2020-09-02T17:00:00,ITA,7,Liguria,44.41149315,8.9326992,38,6,44,563,607,47,8839,1571,11017,130214
4019,2020-09-02T17:00:00,ITA,3,Lombardia,45.46679409,9.190347404,220,22,242,7036,7278,237,76407,16869,100554,998868
4020,2020-09-02T17:00:00,ITA,11,Marche,43.61675973,13.5188753,14,1,15,305,320,17,5966,987,7273,123648
4021,2020-09-02T17:00:00,ITA,14,Molise,41.55774754,14.65916051,3,0,3,70,73,0,432,23,528,32812
4022,2020-09-02T17:00:00,ITA,21,P.A. Bolzano,46.49933453,11.35662422,8,2,10,196,206,10,2460,292,2958,74019
4023,2020-09-02T17:00:00,ITA,22,P.A. Trento,46.06893511,11.12123097,4,1,5,118,123,33,4604,405,5132,83762
4024,2020-09-02T17:00:00,ITA,1,Piemonte,45.0732745,7.680687483,90,7,97,1424,1521,66,27321,4147,32989,366797
4025,2020-09-02T17:00:00,ITA,16,Puglia,41.12559576,16.86736689,140,6,146,776,922,67,4067,557,5546,221391
4026,2020-09-02T17:00:00,ITA,20,Sardegna,39.21531192,9.110616306,32,5,37,872,909,73,1272,135,2316,118433
4027,2020-09-02T17:00:00,ITA,19,Sicilia,38.11569725,13.3623567,76,12,88,1139,1227,83,2919,287,4433,272775
4028,2020-09-02T17:00:00,ITA,9,Toscana,43.76923077,11.25588885,58,8,66,1570,1636,69,9189,1142,11967,365415
4029,2020-09-02T17:00:00,ITA,10,Umbria,43.10675841,12.38824698,8,2,10,288,298,27,1452,80,1830,97623
4030,2020-09-02T17:00:00,ITA,2,Valle d'Aosta,45.73750286,7.320149366,3,0,3,29,32,2,1065,146,1243,17785
4031,2020-09-02T17:00:00,ITA,5,Veneto,45.43490485,12.33845213,70,9,79,2477,2556,163,18510,2123,23189,622175
4032,2020-09-03T17:00:00,ITA,13,Abruzzo,42.35122196,13.39843823,33,1,34,420,454,24,2902,472,3828,104572
4033,2020-09-03T17:00:00,ITA,17,Basilicata,40.63947052,15.80514834,2,1,3,102,105,15,408,28,541,57240
4034,2020-09-03T17:00:00,ITA,18,Calabria,38.90597598,16.59440194,20,1,21,273,294,13,1167,97,1558,158698
4035,2020-09-03T17:00:00,ITA,15,Campania,40.83956555,14.25084984,185,4,189,2391,2580,193,4452,446,7478,252337
4036,2020-09-03T17:00:00,ITA,8,Emilia-Romagna,44.49436681,11.3417208,108,11,119,3066,3185,118,24598,4463,32246,546180
4037,2020-09-03T17:00:00,ITA,6,Friuli Venezia Giulia,45.6494354,13.76813649,12,3,15,387,402,25,3080,349,3831,155933
4038,2020-09-03T17:00:00,ITA,12,Lazio,41.89277044,12.48366722,351,9,360,3184,3544,154,7177,879,11600,506670
4039,2020-09-03T17:00:00,ITA,7,Liguria,44.41149315,8.9326992,39,7,46,581,627,22,8840,1572,11039,131659
4040,2020-09-03T17:00:00,ITA,3,Lombardia,45.46679409,9.190347404,225,27,252,7193,7445,228,76467,16870,100782,1008369
4041,2020-09-03T17:00:00,ITA,11,Marche,43.61675973,13.5188753,13,1,14,321,335,21,5971,988,7294,124694
4042,2020-09-03T17:00:00,ITA,14,Molise,41.55774754,14.65916051,3,0,3,72,75,2,432,23,530,33143
4043,2020-09-03T17:00:00,ITA,21,P.A. Bolzano,46.49933453,11.35662422,8,2,10,196,206,4,2464,292,2962,74513
4044,2020-09-03T17:00:00,ITA,22,P.A. Trento,46.06893511,11.12123097,3,1,4,206,210,91,4608,405,5223,84365
4045,2020-09-03T17:00:00,ITA,1,Piemonte,45.0732745,7.680687483,92,7,99,1487,1586,75,27330,4148,33064,369467
4046,2020-09-03T17:00:00,ITA,16,Puglia,41.12559576,16.86736689,148,6,154,832,986,78,4078,560,5624,224094
4047,2020-09-03T17:00:00,ITA,20,Sardegna,39.21531192,9.110616306,35,6,41,905,946,39,1274,135,2355,120029
4048,2020-09-03T17:00:00,ITA,19,Sicilia,38.11569725,13.3623567,81,12,93,1159,1252,54,2947,288,4487,275130
4049,2020-09-03T17:00:00,ITA,9,Toscana,43.76923077,11.25588885,63,7,70,1661,1731,113,9206,1143,12080,371628
4050,2020-09-03T17:00:00,ITA,10,Umbria,43.10675841,12.38824698,10,2,12,290,302,9,1457,80,1839,98418
4051,2020-09-03T17:00:00,ITA,2,Valle d'Aosta,45.73750286,7.320149366,3,0,3,33,36,4,1065,146,1247,17863
4052,2020-09-03T17:00:00,ITA,5,Veneto,45.43490485,12.33845213,71,12,83,2531,2614,115,18567,2123,23304,627148
4053,2020-09-04T17:00:00,ITA,13,Abruzzo,42.35122196,13.39843823,32,1,33,438,471,25,2910,472,3853,105546
4054,2020-09-04T17:00:00,ITA,17,Basilicata,40.63947052,15.80514834,3,1,4,104,108,7,412,28,548,57880
4055,2020-09-04T17:00:00,ITA,18,Calabria,38.90597598,16.59440194,19,1,20,293,313,19,1167,97,1577,160382
4056,2020-09-04T17:00:00,ITA,15,Campania,40.83956555,14.25084984,196,5,201,2530,2731,171,4471,447,7649,257337
4057,2020-09-04T17:00:00,ITA,8,Emilia-Romagna,44.49436681,11.3417208,114,13,127,3062,3189,126,24719,4463,32371,551727
4058,2020-09-04T17:00:00,ITA,6,Friuli Venezia Giulia,45.6494354,13.76813649,11,4,15,397,412,23,3093,349,3854,156816
4059,2020-09-04T17:00:00,ITA,12,Lazio,41.89277044,12.48366722,363,9,372,3316,3688,171,7204,879,11771,517073
4060,2020-09-04T17:00:00,ITA,7,Liguria,44.41149315,8.9326992,48,6,54,619,673,47,8841,1572,11086,132733
4061,2020-09-04T17:00:00,ITA,3,Lombardia,45.46679409,9.190347404,244,26,270,7399,7669,337,76574,16876,101119,1028404
4062,2020-09-04T17:00:00,ITA,11,Marche,43.61675973,13.5188753,12,1,13,328,341,17,5982,988,7311,125411
4063,2020-09-04T17:00:00,ITA,14,Molise,41.55774754,14.65916051,3,0,3,75,78,4,433,23,534,33340
4064,2020-09-04T17:00:00,ITA,21,P.A. Bolzano,46.49933453,11.35662422,8,2,10,199,209,11,2472,292,2973,74949
4065,2020-09-04T17:00:00,ITA,22,P.A. Trento,46.06893511,11.12123097,7,0,7,223,230,23,4611,405,5246,84881
4066,2020-09-04T17:00:00,ITA,1,Piemonte,45.0732745,7.680687483,110,7,117,1531,1648,82,27349,4149,33146,372210
4067,2020-09-04T17:00:00,ITA,16,Puglia,41.12559576,16.86736689,150,7,157,929,1086,117,4095,560,5741,226927
4068,2020-09-04T17:00:00,ITA,20,Sardegna,39.21531192,9.110616306,41,6,47,963,1010,66,1276,135,2421,121848
4069,2020-09-04T17:00:00,ITA,19,Sicilia,38.11569725,13.3623567,87,11,98,1186,1284,78,2993,288,4565,277515
4070,2020-09-04T17:00:00,ITA,9,Toscana,43.76923077,11.25588885,67,8,75,1742,1817,99,9219,1143,12179,377468
4071,2020-09-04T17:00:00,ITA,10,Umbria,43.10675841,12.38824698,11,3,14,313,327,35,1467,80,1874,99741
4072,2020-09-04T17:00:00,ITA,2,Valle d'Aosta,45.73750286,7.320149366,2,0,2,33,35,2,1068,146,1249,17904
4073,2020-09-04T17:00:00,ITA,5,Veneto,45.43490485,12.33845213,79,10,89,2691,2780,273,18671,2126,23577,634616
4074,2020-09-05T17:00:00,ITA,13,Abruzzo,42.35122196,13.39843823,32,2,34,449,483,13,2910,472,3865,106544
4075,2020-09-05T17:00:00,ITA,17,Basilicata,40.63947052,15.80514834,3,1,4,111,115,7,412,28,555,58544
4076,2020-09-05T17:00:00,ITA,18,Calabria,38.90597598,16.59440194,20,0,20,305,325,19,1173,98,1596,162336
4077,2020-09-05T17:00:00,ITA,15,Campania,40.83956555,14.25084984,207,6,213,2631,2844,119,4476,448,7768,263202
4078,2020-09-05T17:00:00,ITA,8,Emilia-Romagna,44.49436681,11.3417208,122,12,134,3117,3251,133,24790,4463,32504,556876
4079,2020-09-05T17:00:00,ITA,6,Friuli Venezia Giulia,45.6494354,13.76813649,15,3,18,427,445,49,3109,349,3903,157947
4080,2020-09-05T17:00:00,ITA,12,Lazio,41.89277044,12.48366722,344,11,355,3452,3807,158,7242,880,11929,526843
4081,2020-09-05T17:00:00,ITA,7,Liguria,44.41149315,8.9326992,54,7,61,646,707,95,8901,1573,11181,134393
4082,2020-09-05T17:00:00,ITA,3,Lombardia,45.46679409,9.190347404,245,23,268,7654,7922,388,76708,16877,101507,1044945
4083,2020-09-05T17:00:00,ITA,11,Marche,43.61675973,13.5188753,13,1,14,355,369,32,5986,988,7343,126276
4084,2020-09-05T17:00:00,ITA,14,Molise,41.55774754,14.65916051,3,0,3,72,75,0,436,23,534,33674
4085,2020-09-05T17:00:00,ITA,21,P.A. Bolzano,46.49933453,11.35662422,8,2,10,208,218,23,2486,292,2996,75681
4086,2020-09-05T17:00:00,ITA,22,P.A. Trento,46.06893511,11.12123097,6,0,6,270,276,53,4618,405,5299,85463
4087,2020-09-05T17:00:00,ITA,1,Piemonte,45.0732745,7.680687483,106,7,113,1572,1685,54,27365,4150,33200,374263
4088,2020-09-05T17:00:00,ITA,16,Puglia,41.12559576,16.86736689,148,7,155,967,1122,55,4112,562,5796,230046
4089,2020-09-05T17:00:00,ITA,20,Sardegna,39.21531192,9.110616306,44,8,52,1018,1070,65,1280,136,2486,123894
4090,2020-09-05T17:00:00,ITA,19,Sicilia,38.11569725,13.3623567,88,12,100,1243,1343,114,3047,289,4679,281041
4091,2020-09-05T17:00:00,ITA,9,Toscana,43.76923077,11.25588885,69,8,77,1812,1889,113,9260,1143,12292,383856
4092,2020-09-05T17:00:00,ITA,10,Umbria,43.10675841,12.38824698,13,2,15,322,337,16,1472,81,1890,100626
4093,2020-09-05T17:00:00,ITA,2,Valle d'Aosta,45.73750286,7.320149366,1,0,1,33,34,0,1069,146,1249,17954
4094,2020-09-05T17:00:00,ITA,5,Veneto,45.43490485,12.33845213,79,9,88,2789,2877,188,18758,2130,23765,639941
4095,2020-09-06T17:00:00,ITA,13,Abruzzo,42.35122196,13.39843823,32,2,34,475,509,26,2910,472,3891,107501
4096,2020-09-06T17:00:00,ITA,17,Basilicata,40.63947052,15.80514834,4,1,5,118,123,9,413,28,564,58988
4097,2020-09-06T17:00:00,ITA,18,Calabria,38.90597598,16.59440194,25,0,25,324,349,27,1176,98,1623,163844
4098,2020-09-06T17:00:00,ITA,15,Campania,40.83956555,14.25084984,221,7,228,2714,2942,100,4478,448,7868,268075
4099,2020-09-06T17:00:00,ITA,8,Emilia-Romagna,44.49436681,11.3417208,124,14,138,3232,3370,124,24794,4464,32628,563905
4100,2020-09-06T17:00:00,ITA,6,Friuli Venezia Giulia,45.6494354,13.76813649,15,4,19,440,459,20,3115,349,3923,158395
4101,2020-09-06T17:00:00,ITA,12,Lazio,41.89277044,12.48366722,355,10,365,3548,3913,122,7257,881,12051,536609
4102,2020-09-06T17:00:00,ITA,7,Liguria,44.41149315,8.9326992,62,9,71,697,768,111,8949,1575,11292,135222
4103,2020-09-06T17:00:00,ITA,3,Lombardia,45.46679409,9.190347404,248,25,273,7758,8031,198,76794,16880,101705,1053199
4104,2020-09-06T17:00:00,ITA,11,Marche,43.61675973,13.5188753,14,1,15,370,385,20,5990,988,7363,127083
4105,2020-09-06T17:00:00,ITA,14,Molise,41.55774754,14.65916051,3,0,3,74,77,2,436,23,536,33934
4106,2020-09-06T17:00:00,ITA,21,P.A. Bolzano,46.49933453,11.35662422,8,2,10,208,218,7,2493,292,3003,75898
4107,2020-09-06T17:00:00,ITA,22,P.A. Trento,46.06893511,11.12123097,5,0,5,293,298,33,4629,405,5332,86002
4108,2020-09-06T17:00:00,ITA,1,Piemonte,45.0732745,7.680687483,111,8,119,1608,1727,56,27379,4150,33256,376721
4109,2020-09-06T17:00:00,ITA,16,Puglia,41.12559576,16.86736689,155,7,162,1005,1167,60,4126,563,5856,231577
4110,2020-09-06T17:00:00,ITA,20,Sardegna,39.21531192,9.110616306,45,8,53,1032,1085,19,1284,136,2505,124985
4111,2020-09-06T17:00:00,ITA,19,Sicilia,38.11569725,13.3623567,86,13,99,1235,1334,37,3093,289,4716,282977
4112,2020-09-06T17:00:00,ITA,9,Toscana,43.76923077,11.25588885,77,8,85,1909,1994,122,9277,1143,12414,390411
4113,2020-09-06T17:00:00,ITA,10,Umbria,43.10675841,12.38824698,13,2,15,341,356,25,1478,81,1915,101440
4114,2020-09-06T17:00:00,ITA,2,Valle d'Aosta,45.73750286,7.320149366,1,0,1,33,34,0,1069,146,1249,18011
4115,2020-09-06T17:00:00,ITA,5,Veneto,45.43490485,12.33845213,79,12,91,2848,2939,179,18875,2130,23944,643251
4116,2020-09-07T17:00:00,ITA,13,Abruzzo,42.35122196,13.39843823,31,2,33,487,520,15,2914,472,3906,108107
4117,2020-09-07T17:00:00,ITA,17,Basilicata,40.63947052,15.80514834,4,1,5,114,119,1,418,28,565,59060
4118,2020-09-07T17:00:00,ITA,18,Calabria,38.90597598,16.59440194,29,1,30,325,355,17,1187,98,1640,164464
4119,2020-09-07T17:00:00,ITA,15,Campania,40.83956555,14.25084984,223,7,230,2960,3190,218,4490,448,8128,271727
4120,2020-09-07T17:00:00,ITA,8,Emilia-Romagna,44.49436681,11.3417208,119,18,137,3356,3493,132,24803,4464,32760,568812
4121,2020-09-07T17:00:00,ITA,6,Friuli Venezia Giulia,45.6494354,13.76813649,16,4,20,442,462,11,3123,349,3934,159063
4122,2020-09-07T17:00:00,ITA,12,Lazio,41.89277044,12.48366722,359,9,368,3667,4035,159,7294,881,12210,545694
4123,2020-09-07T17:00:00,ITA,7,Liguria,44.41149315,8.9326992,67,10,77,746,823,59,8951,1577,11351,135646
4124,2020-09-07T17:00:00,ITA,3,Lombardia,45.46679409,9.190347404,242,26,268,7842,8110,109,76818,16886,101814,1059954
4125,2020-09-07T17:00:00,ITA,11,Marche,43.61675973,13.5188753,16,1,17,370,387,6,5994,988,7369,127431
4126,2020-09-07T17:00:00,ITA,14,Molise,41.55774754,14.65916051,3,0,3,83,86,9,436,23,545,34109
4127,2020-09-07T17:00:00,ITA,21,P.A. Bolzano,46.49933453,11.35662422,8,2,10,205,215,0,2496,292,3003,76265
4128,2020-09-07T17:00:00,ITA,22,P.A. Trento,46.06893511,11.12123097,5,0,5,310,315,17,4629,405,5349,86198
4129,2020-09-07T17:00:00,ITA,1,Piemonte,45.0732745,7.680687483,105,8,113,1639,1752,37,27390,4151,33293,378191
4130,2020-09-07T17:00:00,ITA,16,Puglia,41.12559576,16.86736689,167,6,173,1024,1197,43,4137,565,5899,233159
4131,2020-09-07T17:00:00,ITA,20,Sardegna,39.21531192,9.110616306,46,10,56,1086,1142,59,1286,136,2564,126031
4132,2020-09-07T17:00:00,ITA,19,Sicilia,38.11569725,13.3623567,101,13,114,1265,1379,49,3097,289,4765,284332
4133,2020-09-07T17:00:00,ITA,9,Toscana,43.76923077,11.25588885,77,9,86,1984,2070,85,9285,1144,12499,395285
4134,2020-09-07T17:00:00,ITA,10,Umbria,43.10675841,12.38824698,15,2,17,349,366,13,1481,81,1928,101836
4135,2020-09-07T17:00:00,ITA,2,Valle d'Aosta,45.73750286,7.320149366,1,0,1,33,34,0,1069,146,1249,18111
4136,2020-09-07T17:00:00,ITA,5,Veneto,45.43490485,12.33845213,85,13,98,2845,2943,69,18940,2130,24013,645256
4137,2020-09-08T17:00:00,ITA,13,Abruzzo,42.35122196,13.39843823,34,2,36,487,523,14,2924,472,3919,108691
4138,2020-09-08T17:00:00,ITA,17,Basilicata,40.63947052,15.80514834,4,1,5,120,125,8,420,28,573,59819
4139,2020-09-08T17:00:00,ITA,18,Calabria,38.90597598,16.59440194,29,1,30,326,356,8,1194,98,1648,165632
4140,2020-09-08T17:00:00,ITA,15,Campania,40.83956555,14.25084984,220,9,229,3186,3415,249,4514,448,8377,277421
4141,2020-09-08T17:00:00,ITA,8,Emilia-Romagna,44.49436681,11.3417208,130,16,146,3386,3532,94,24857,4465,32854,572945
4142,2020-09-08T17:00:00,ITA,6,Friuli Venezia Giulia,45.6494354,13.76813649,18,4,22,451,473,12,3124,349,3946,159635
4143,2020-09-08T17:00:00,ITA,12,Lazio,41.89277044,12.48366722,354,9,363,3761,4124,129,7334,881,12339,554654
4144,2020-09-08T17:00:00,ITA,7,Liguria,44.41149315,8.9326992,85,11,96,764,860,64,8977,1578,11415,137135
4145,2020-09-08T17:00:00,ITA,3,Lombardia,45.46679409,9.190347404,248,27,275,7946,8221,271,76976,16888,102085,1073431
4146,2020-09-08T17:00:00,ITA,11,Marche,43.61675973,13.5188753,16,1,17,380,397,15,5999,988,7384,128178
4147,2020-09-08T17:00:00,ITA,14,Molise,41.55774754,14.65916051,5,0,5,83,88,3,437,23,548,34263
4148,2020-09-08T17:00:00,ITA,21,P.A. Bolzano,46.49933453,11.35662422,8,0,8,210,218,4,2497,292,3007,76699
4149,2020-09-08T17:00:00,ITA,22,P.A. Trento,46.06893511,11.12123097,6,0,6,311,317,3,4630,405,5352,86431
4150,2020-09-08T17:00:00,ITA,1,Piemonte,45.0732745,7.680687483,104,9,113,1656,1769,42,27414,4152,33335,380476
4151,2020-09-08T17:00:00,ITA,16,Puglia,41.12559576,16.86736689,163,7,170,1151,1321,143,4154,567,6042,236175
4152,2020-09-08T17:00:00,ITA,20,Sardegna,39.21531192,9.110616306,48,10,58,1135,1193,51,1286,136,2615,127300
4153,2020-09-08T17:00:00,ITA,19,Sicilia,38.11569725,13.3623567,104,13,117,1337,1454,84,3106,289,4849,287589
4154,2020-09-08T17:00:00,ITA,9,Toscana,43.76923077,11.25588885,74,9,83,1996,2079,59,9334,1145,12558,399495
4155,2020-09-08T17:00:00,ITA,10,Umbria,43.10675841,12.38824698,15,2,17,354,371,7,1483,81,1935,102837
4156,2020-09-08T17:00:00,ITA,2,Valle d'Aosta,45.73750286,7.320149366,2,0,2,37,39,5,1069,146,1254,18188
4157,2020-09-08T17:00:00,ITA,5,Veneto,45.43490485,12.33845213,93,12,105,2809,2914,105,19072,2132,24118,649669
4158,2020-09-09T17:00:00,ITA,13,Abruzzo,42.35122196,13.39843823,35,2,37,469,506,5,2943,472,3921,109697
4159,2020-09-09T17:00:00,ITA,17,Basilicata,40.63947052,15.80514834,4,1,5,133,138,14,421,28,587,60500
4160,2020-09-09T17:00:00,ITA,18,Calabria,38.90597598,16.59440194,27,2,29,333,362,19,1207,98,1667,167110
4161,2020-09-09T17:00:00,ITA,15,Campania,40.83956555,14.25084984,226,10,236,3358,3594,203,4537,449,8580,283355
4162,2020-09-09T17:00:00,ITA,8,Emilia-Romagna,44.49436681,11.3417208,140,16,156,3398,3554,110,24942,4467,32963,578121
4163,2020-09-09T17:00:00,ITA,6,Friuli Venezia Giulia,45.6494354,13.76813649,17,3,20,491,511,54,3140,349,4000,161026
4164,2020-09-09T17:00:00,ITA,12,Lazio,41.89277044,12.48366722,358,9,367,3903,4270,175,7363,881,12514,563118
4165,2020-09-09T17:00:00,ITA,7,Liguria,44.41149315,8.9326992,87,11,98,809,907,51,8980,1579,11466,138436
4166,2020-09-09T17:00:00,ITA,3,Lombardia,45.46679409,9.190347404,252,27,279,8045,8324,218,77088,16891,102303,1087646
4167,2020-09-09T17:00:00,ITA,11,Marche,43.61675973,13.5188753,14,2,16,394,410,19,6005,988,7403,129006
4168,2020-09-09T17:00:00,ITA,14,Molise,41.55774754,14.65916051,4,0,4,88,92,4,437,23,552,34699
4169,2020-09-09T17:00:00,ITA,21,P.A. Bolzano,46.49933453,11.35662422,8,0,8,215,223,10,2502,292,3017,77178
4170,2020-09-09T17:00:00,ITA,22,P.A. Trento,46.06893511,11.12123097,7,0,7,313,320,7,4634,405,5359,86802
4171,2020-09-09T17:00:00,ITA,1,Piemonte,45.0732745,7.680687483,100,9,109,1755,1864,112,27431,4152,33447,383250
4172,2020-09-09T17:00:00,ITA,16,Puglia,41.12559576,16.86736689,172,6,178,1236,1414,97,4158,567,6139,239744
4173,2020-09-09T17:00:00,ITA,20,Sardegna,39.21531192,9.110616306,51,12,63,1170,1233,47,1291,138,2662,128433
4174,2020-09-09T17:00:00,ITA,19,Sicilia,38.11569725,13.3623567,105,15,120,1407,1527,77,3110,289,4926,290674
4175,2020-09-09T17:00:00,ITA,9,Toscana,43.76923077,11.25588885,69,11,80,2061,2141,88,9358,1147,12646,404903
4176,2020-09-09T17:00:00,ITA,10,Umbria,43.10675841,12.38824698,17,2,19,354,373,33,1514,81,1968,103775
4177,2020-09-09T17:00:00,ITA,2,Valle d'Aosta,45.73750286,7.320149366,2,0,2,32,34,0,1074,146,1254,18254
4178,2020-09-09T17:00:00,ITA,5,Veneto,45.43490485,12.33845213,83,12,95,2842,2937,91,19137,2135,24209,653982
4179,2020-09-10T17:00:00,ITA,13,Abruzzo,42.35122196,13.39843823,35,3,38,474,512,11,2948,472,3932,110567
4180,2020-09-10T17:00:00,ITA,17,Basilicata,40.63947052,15.80514834,4,1,5,138,143,6,422,28,593,61164
4181,2020-09-10T17:00:00,ITA,18,Calabria,38.90597598,16.59440194,28,3,31,339,370,8,1207,98,1675,168505
4182,2020-09-10T17:00:00,ITA,15,Campania,40.83956555,14.25084984,232,10,242,3500,3742,180,4568,450,8760,289379
4183,2020-09-10T17:00:00,ITA,8,Emilia-Romagna,44.49436681,11.3417208,143,17,160,3451,3611,110,24994,4468,33073,582928
4184,2020-09-10T17:00:00,ITA,6,Friuli Venezia Giulia,45.6494354,13.76813649,17,3,20,526,546,39,3144,349,4039,161912
4185,2020-09-10T17:00:00,ITA,12,Lazio,41.89277044,12.48366722,372,9,381,4001,4382,163,7413,882,12677,571817
4186,2020-09-10T17:00:00,ITA,7,Liguria,44.41149315,8.9326992,91,11,102,839,941,114,9060,1579,11580,139851
4187,2020-09-10T17:00:00,ITA,3,Lombardia,45.46679409,9.190347404,256,30,286,8166,8452,245,77204,16892,102548,1098986
4188,2020-09-10T17:00:00,ITA,11,Marche,43.61675973,13.5188753,11,2,13,426,439,40,6015,989,7443,129830
4189,2020-09-10T17:00:00,ITA,14,Molise,41.55774754,14.65916051,4,0,4,91,95,3,437,23,555,35157
4190,2020-09-10T17:00:00,ITA,21,P.A. Bolzano,46.49933453,11.35662422,8,0,8,231,239,20,2506,292,3037,77764
4191,2020-09-10T17:00:00,ITA,22,P.A. Trento,46.06893511,11.12123097,6,0,6,392,398,82,4638,405,5441,87467
4192,2020-09-10T17:00:00,ITA,1,Piemonte,45.0732745,7.680687483,110,9,119,1799,1918,74,27450,4153,33521,385183
4193,2020-09-10T17:00:00,ITA,16,Puglia,41.12559576,16.86736689,179,8,187,1283,1470,70,4169,570,6209,242098
4194,2020-09-10T17:00:00,ITA,20,Sardegna,39.21531192,9.110616306,57,12,69,1217,1286,63,1300,139,2725,130074
4195,2020-09-10T17:00:00,ITA,19,Sicilia,38.11569725,13.3623567,108,18,126,1477,1603,106,3140,289,5032,293401
4196,2020-09-10T17:00:00,ITA,9,Toscana,43.76923077,11.25588885,74,13,87,2127,2214,92,9377,1147,12738,409901
4197,2020-09-10T17:00:00,ITA,10,Umbria,43.10675841,12.38824698,16,3,19,371,390,24,1521,81,1992,104824
4198,2020-09-10T17:00:00,ITA,2,Valle d'Aosta,45.73750286,7.320149366,2,0,2,29,31,0,1077,146,1254,18332
4199,2020-09-10T17:00:00,ITA,5,Veneto,45.43490485,12.33845213,83,12,95,2831,2926,147,19295,2135,24356,658348
4200,2020-09-11T17:00:00,ITA,13,Abruzzo,42.35122196,13.39843823,36,4,40,501,541,35,2954,472,3967,111700
4201,2020-09-11T17:00:00,ITA,17,Basilicata,40.63947052,15.80514834,4,1,5,149,154,12,423,28,605,61777
4202,2020-09-11T17:00:00,ITA,18,Calabria,38.90597598,16.59440194,28,3,31,339,370,8,1215,98,1683,170074
4203,2020-09-11T17:00:00,ITA,15,Campania,40.83956555,14.25084984,239,13,252,3613,3865,140,4584,451,8900,296120
4204,2020-09-11T17:00:00,ITA,8,Emilia-Romagna,44.49436681,11.3417208,140,18,158,3572,3730,152,25027,4468,33225,587767
4205,2020-09-11T17:00:00,ITA,6,Friuli Venezia Giulia,45.6494354,13.76813649,17,3,20,542,562,34,3162,349,4073,162976
4206,2020-09-11T17:00:00,ITA,12,Lazio,41.89277044,12.48366722,365,14,379,4097,4476,148,7466,883,12825,581864
4207,2020-09-11T17:00:00,ITA,7,Liguria,44.41149315,8.9326992,96,12,108,886,994,82,9089,1579,11662,141350
4208,2020-09-11T17:00:00,ITA,3,Lombardia,45.46679409,9.190347404,246,27,273,8318,8591,257,77318,16896,102805,1110428
4209,2020-09-11T17:00:00,ITA,11,Marche,43.61675973,13.5188753,13,2,15,451,466,41,6029,989,7484,130636
4210,2020-09-11T17:00:00,ITA,14,Molise,41.55774754,14.65916051,4,0,4,84,88,4,448,23,559,35541
4211,2020-09-11T17:00:00,ITA,21,P.A. Bolzano,46.49933453,11.35662422,8,0,8,247,255,26,2516,292,3063,78315
4212,2020-09-11T17:00:00,ITA,22,P.A. Trento,46.06893511,11.12123097,6,0,6,416,422,29,4643,405,5470,88084
4213,2020-09-11T17:00:00,ITA,1,Piemonte,45.0732745,7.680687483,102,9,111,1849,1960,57,27465,4153,33578,386993
4214,2020-09-11T17:00:00,ITA,16,Puglia,41.12559576,16.86736689,188,8,196,1350,1546,82,4175,570,6291,244885
4215,2020-09-11T17:00:00,ITA,20,Sardegna,39.21531192,9.110616306,61,12,73,1264,1337,65,1314,139,2790,131993
4216,2020-09-11T17:00:00,ITA,19,Sicilia,38.11569725,13.3623567,112,17,129,1577,1706,104,3141,289,5136,295881
4217,2020-09-11T17:00:00,ITA,9,Toscana,43.76923077,11.25588885,72,17,89,2223,2312,147,9425,1148,12885,414906
4218,2020-09-11T17:00:00,ITA,10,Umbria,43.10675841,12.38824698,19,4,23,372,395,17,1533,81,2009,105483
4219,2020-09-11T17:00:00,ITA,2,Valle d'Aosta,45.73750286,7.320149366,2,0,2,31,33,3,1078,146,1257,18368
4220,2020-09-11T17:00:00,ITA,5,Veneto,45.43490485,12.33845213,91,11,102,2862,2964,173,19427,2138,24529,663769
4221,2020-09-12T17:00:00,ITA,13,Abruzzo,42.35122196,13.39843823,37,3,40,504,544,11,2962,472,3978,112658
4222,2020-09-12T17:00:00,ITA,17,Basilicata,40.63947052,15.80514834,5,1,6,149,155,5,427,28,610,62601
4223,2020-09-12T17:00:00,ITA,18,Calabria,38.90597598,16.59440194,28,3,31,357,388,18,1215,98,1701,171604
4224,2020-09-12T17:00:00,ITA,15,Campania,40.83956555,14.25084984,254,17,271,3627,3898,103,4654,451,9003,300981
4225,2020-09-12T17:00:00,ITA,8,Emilia-Romagna,44.49436681,11.3417208,152,17,169,3658,3827,138,25067,4469,33363,592684
4226,2020-09-12T17:00:00,ITA,6,Friuli Venezia Giulia,45.6494354,13.76813649,18,2,20,566,586,39,3177,349,4112,163837
4227,2020-09-12T17:00:00,ITA,12,Lazio,41.89277044,12.48366722,401,16,417,4204,4621,155,7475,884,12980,590692
4228,2020-09-12T17:00:00,ITA,7,Liguria,44.41149315,8.9326992,109,11,120,968,1088,112,9107,1579,11774,142774
4229,2020-09-12T17:00:00,ITA,3,Lombardia,45.46679409,9.190347404,251,27,278,8289,8567,269,77611,16896,103074,1120531
4230,2020-09-12T17:00:00,ITA,11,Marche,43.61675973,13.5188753,12,2,14,472,486,27,6036,989,7511,131401
4231,2020-09-12T17:00:00,ITA,14,Molise,41.55774754,14.65916051,3,0,3,87,90,3,449,23,562,35775
4232,2020-09-12T17:00:00,ITA,21,P.A. Bolzano,46.49933453,11.35662422,8,0,8,258,266,25,2530,292,3088,79095
4233,2020-09-12T17:00:00,ITA,22,P.A. Trento,46.06893511,11.12123097,8,0,8,429,437,22,4650,405,5492,88749
4234,2020-09-12T17:00:00,ITA,1,Piemonte,45.0732745,7.680687483,104,9,113,1917,2030,93,27488,4153,33671,388781
4235,2020-09-12T17:00:00,ITA,16,Puglia,41.12559576,16.86736689,189,8,197,1402,1599,76,4198,570,6367,248777
4236,2020-09-12T17:00:00,ITA,20,Sardegna,39.21531192,9.110616306,62,14,76,1303,1379,51,1322,140,2841,133503
4237,2020-09-12T17:00:00,ITA,19,Sicilia,38.11569725,13.3623567,116,18,134,1613,1747,44,3144,289,5180,298359
4238,2020-09-12T17:00:00,ITA,9,Toscana,43.76923077,11.25588885,74,18,92,2310,2402,138,9473,1148,13023,419422
4239,2020-09-12T17:00:00,ITA,10,Umbria,43.10675841,12.38824698,18,4,22,397,419,33,1542,81,2042,106482
4240,2020-09-12T17:00:00,ITA,2,Valle d'Aosta,45.73750286,7.320149366,3,0,3,31,34,1,1078,146,1258,18424
4241,2020-09-12T17:00:00,ITA,5,Veneto,45.43490485,12.33845213,99,12,111,2829,2940,138,19586,2141,24667,668332
4242,2020-09-13T17:00:00,ITA,13,Abruzzo,42.35122196,13.39843823,41,3,44,535,579,37,2964,472,4015,113956
4243,2020-09-13T17:00:00,ITA,17,Basilicata,40.63947052,15.80514834,5,1,6,150,156,3,429,28,613,62961
4244,2020-09-13T17:00:00,ITA,18,Calabria,38.90597598,16.59440194,29,3,32,363,395,14,1222,98,1715,172919
4245,2020-09-13T17:00:00,ITA,15,Campania,40.83956555,14.25084984,271,19,290,3651,3941,122,4733,451,9125,304705
4246,2020-09-13T17:00:00,ITA,8,Emilia-Romagna,44.49436681,11.3417208,156,17,173,3766,3939,143,25096,4469,33504,597178
4247,2020-09-13T17:00:00,ITA,6,Friuli Venezia Giulia,45.6494354,13.76813649,23,2,25,564,589,45,3219,349,4157,164825
4248,2020-09-13T17:00:00,ITA,12,Lazio,41.89277044,12.48366722,424,17,441,4314,4755,143,7483,885,13123,598963
4249,2020-09-13T17:00:00,ITA,7,Liguria,44.41149315,8.9326992,115,11,126,1017,1143,78,9130,1579,11852,143543
4250,2020-09-13T17:00:00,ITA,3,Lombardia,45.46679409,9.190347404,252,28,280,8509,8789,265,77651,16899,103339,1128937
4251,2020-09-13T17:00:00,ITA,11,Marche,43.61675973,13.5188753,14,2,16,504,520,39,6041,989,7550,132323
4252,2020-09-13T17:00:00,ITA,14,Molise,41.55774754,14.65916051,3,1,4,89,93,3,449,23,565,36107
4253,2020-09-13T17:00:00,ITA,21,P.A. Bolzano,46.49933453,11.35662422,8,0,8,288,296,40,2540,292,3128,79873
4254,2020-09-13T17:00:00,ITA,22,P.A. Trento,46.06893511,11.12123097,9,0,9,433,442,9,4654,405,5501,89234
4255,2020-09-13T17:00:00,ITA,1,Piemonte,45.0732745,7.680687483,100,8,108,1989,2097,82,27503,4153,33753,391637
4256,2020-09-13T17:00:00,ITA,16,Puglia,41.12559576,16.86736689,195,9,204,1474,1678,82,4201,570,6449,250467
4257,2020-09-13T17:00:00,ITA,20,Sardegna,39.21531192,9.110616306,80,14,94,1310,1404,33,1330,140,2874,134443
4258,2020-09-13T17:00:00,ITA,19,Sicilia,38.11569725,13.3623567,120,17,137,1656,1793,61,3158,290,5241,300490
4259,2020-09-13T17:00:00,ITA,9,Toscana,43.76923077,11.25588885,80,17,97,2362,2459,91,9506,1149,13114,424101
4260,2020-09-13T17:00:00,ITA,10,Umbria,43.10675841,12.38824698,19,4,23,415,438,24,1547,81,2066,107219
4261,2020-09-13T17:00:00,ITA,2,Valle d'Aosta,45.73750286,7.320149366,3,0,3,33,36,2,1078,146,1260,18539
4262,2020-09-13T17:00:00,ITA,5,Veneto,45.43490485,12.33845213,95,14,109,2858,2967,142,19700,2142,24809,671902
4263,2020-09-14T17:00:00,ITA,13,Abruzzo,42.35122196,13.39843823,41,4,45,532,577,1,2966,473,4016,114031
4264,2020-09-14T17:00:00,ITA,17,Basilicata,40.63947052,15.80514834,5,1,6,150,156,0,429,28,613,63023
4265,2020-09-14T17:00:00,ITA,18,Calabria,38.90597598,16.59440194,29,2,31,344,375,3,1245,98,1718,173593
4266,2020-09-14T17:00:00,ITA,15,Campania,40.83956555,14.25084984,286,19,305,3699,4004,90,4759,452,9215,306866
4267,2020-09-14T17:00:00,ITA,8,Emilia-Romagna,44.49436681,11.3417208,165,18,183,3881,4064,127,25098,4469,33631,599934
4268,2020-09-14T17:00:00,ITA,6,Friuli Venezia Giulia,45.6494354,13.76813649,22,3,25,567,592,4,3220,349,4161,165276
4269,2020-09-14T17:00:00,ITA,12,Lazio,41.89277044,12.48366722,410,17,427,4469,4896,181,7523,885,13304,606736
4270,2020-09-14T17:00:00,ITA,7,Liguria,44.41149315,8.9326992,126,12,138,1062,1200,65,9135,1582,11917,144077
4271,2020-09-14T17:00:00,ITA,3,Lombardia,45.46679409,9.190347404,262,28,290,8558,8848,125,77715,16901,103464,1134109
4272,2020-09-14T17:00:00,ITA,11,Marche,43.61675973,13.5188753,15,2,17,511,528,11,6044,989,7561,132543
4273,2020-09-14T17:00:00,ITA,14,Molise,41.55774754,14.65916051,4,1,5,91,96,4,450,23,569,36332
4274,2020-09-14T17:00:00,ITA,21,P.A. Bolzano,46.49933453,11.35662422,8,0,8,295,303,7,2540,292,3135,80293
4275,2020-09-14T17:00:00,ITA,22,P.A. Trento,46.06893511,11.12123097,11,0,11,448,459,20,4657,405,5521,89459
4276,2020-09-14T17:00:00,ITA,1,Piemonte,45.0732745,7.680687483,114,9,123,2006,2129,61,27532,4153,33814,393413
4277,2020-09-14T17:00:00,ITA,16,Puglia,41.12559576,16.86736689,203,11,214,1499,1713,61,4225,572,6510,252699
4278,2020-09-14T17:00:00,ITA,20,Sardegna,39.21531192,9.110616306,85,16,101,1339,1440,54,1348,140,2928,135511
4279,2020-09-14T17:00:00,ITA,19,Sicilia,38.11569725,13.3623567,136,16,152,1690,1842,65,3172,292,5306,301876
4280,2020-09-14T17:00:00,ITA,9,Toscana,43.76923077,11.25588885,82,18,100,2400,2500,59,9523,1150,13173,426415
4281,2020-09-14T17:00:00,ITA,10,Umbria,43.10675841,12.38824698,19,5,24,419,443,12,1554,81,2078,107533
4282,2020-09-14T17:00:00,ITA,2,Valle d'Aosta,45.73750286,7.320149366,3,1,4,35,39,3,1078,146,1263,18560
4283,2020-09-14T17:00:00,ITA,5,Veneto,45.43490485,12.33845213,96,14,110,2873,2983,55,19737,2144,24864,673892
4284,2020-09-15T17:00:00,ITA,13,Abruzzo,42.35122196,13.39843823,42,4,46,545,591,18,2970,473,4034,114687
4285,2020-09-15T17:00:00,ITA,17,Basilicata,40.63947052,15.80514834,6,1,7,154,161,5,429,28,618,63520
4286,2020-09-15T17:00:00,ITA,18,Calabria,38.90597598,16.59440194,31,2,33,341,374,4,1250,98,1722,174778
4287,2020-09-15T17:00:00,ITA,15,Campania,40.83956555,14.25084984,295,18,313,3767,4080,136,4819,452,9351,310227
4288,2020-09-15T17:00:00,ITA,8,Emilia-Romagna,44.49436681,11.3417208,168,17,185,3917,4102,125,25184,4470,33756,603369
4289,2020-09-15T17:00:00,ITA,6,Friuli Venezia Giulia,45.6494354,13.76813649,24,2,26,583,609,20,3223,349,4181,166049
4290,2020-09-15T17:00:00,ITA,12,Lazio,41.89277044,12.48366722,453,18,471,4526,4997,139,7559,887,13443,614394
4291,2020-09-15T17:00:00,ITA,7,Liguria,44.41149315,8.9326992,128,12,140,1111,1251,141,9225,1582,12058,145476
4292,2020-09-15T17:00:00,ITA,3,Lombardia,45.46679409,9.190347404,263,29,292,8507,8799,176,77938,16903,103640,1148425
4293,2020-09-15T17:00:00,ITA,11,Marche,43.61675973,13.5188753,17,2,19,517,536,14,6050,989,7575,133279
4294,2020-09-15T17:00:00,ITA,14,Molise,41.55774754,14.65916051,5,1,6,91,97,1,450,23,570,36565
4295,2020-09-15T17:00:00,ITA,21,P.A. Bolzano,46.49933453,11.35662422,15,1,16,304,320,21,2544,292,3156,80736
4296,2020-09-15T17:00:00,ITA,22,P.A. Trento,46.06893511,11.12123097,9,0,9,465,474,20,4662,405,5541,89798
4297,2020-09-15T17:00:00,ITA,1,Piemonte,45.0732745,7.680687483,112,8,120,2037,2157,39,27543,4153,33853,394783
4298,2020-09-15T17:00:00,ITA,16,Puglia,41.12559576,16.86736689,204,13,217,1559,1776,76,4237,573,6586,255154
4299,2020-09-15T17:00:00,ITA,20,Sardegna,39.21531192,9.110616306,86,18,104,1353,1457,36,1367,140,2964,136896
4300,2020-09-15T17:00:00,ITA,19,Sicilia,38.11569725,13.3623567,141,17,158,1761,1919,77,3172,292,5383,304795
4301,2020-09-15T17:00:00,ITA,9,Toscana,43.76923077,11.25588885,93,17,110,2417,2527,41,9536,1151,13214,429310
4302,2020-09-15T17:00:00,ITA,10,Umbria,43.10675841,12.38824698,23,6,29,430,459,22,1560,81,2100,108521
4303,2020-09-15T17:00:00,ITA,2,Valle d'Aosta,45.73750286,7.320149366,5,0,5,37,42,3,1078,146,1266,18657
4304,2020-09-15T17:00:00,ITA,5,Veneto,45.43490485,12.33845213,102,15,117,2867,2984,115,19849,2146,24979,677256
4305,2020-09-16T17:00:00,ITA,13,Abruzzo,42.35122196,13.39843823,42,5,47,559,606,18,2973,473,4052,115700
4306,2020-09-16T17:00:00,ITA,17,Basilicata,40.63947052,15.80514834,6,1,7,157,164,5,431,28,623,64053
4307,2020-09-16T17:00:00,ITA,18,Calabria,38.90597598,16.59440194,28,2,30,359,389,19,1254,98,1741,176447
4308,2020-09-16T17:00:00,ITA,15,Campania,40.83956555,14.25084984,301,19,320,3877,4197,186,4888,452,9537,315063
4309,2020-09-16T17:00:00,ITA,8,Emilia-Romagna,44.49436681,11.3417208,174,19,193,3986,4179,106,25213,4470,33862,607881
4310,2020-09-16T17:00:00,ITA,6,Friuli Venezia Giulia,45.6494354,13.76813649,22,3,25,587,612,29,3249,349,4210,167456
4311,2020-09-16T17:00:00,ITA,12,Lazio,41.89277044,12.48366722,467,18,485,4643,5128,165,7593,887,13608,621049
4312,2020-09-16T17:00:00,ITA,7,Liguria,44.41149315,8.9326992,136,13,149,1174,1323,73,9225,1583,12131,147046
4313,2020-09-16T17:00:00,ITA,3,Lombardia,45.46679409,9.190347404,264,30,294,8510,8804,159,78090,16905,103799,1160353
4314,2020-09-16T17:00:00,ITA,11,Marche,43.61675973,13.5188753,15,2,17,544,561,38,6063,989,7613,134034
4315,2020-09-16T17:00:00,ITA,14,Molise,41.55774754,14.65916051,3,1,4,95,99,6,454,23,576,36757
4316,2020-09-16T17:00:00,ITA,21,P.A. Bolzano,46.49933453,11.35662422,17,2,19,304,323,12,2553,292,3168,81388
4317,2020-09-16T17:00:00,ITA,22,P.A. Trento,46.06893511,11.12123097,13,0,13,488,501,32,4667,405,5573,90609
4318,2020-09-16T17:00:00,ITA,1,Piemonte,45.0732745,7.680687483,123,6,129,2098,2227,117,27590,4153,33970,397218
4319,2020-09-16T17:00:00,ITA,16,Puglia,41.12559576,16.86736689,204,14,218,1645,1863,103,4252,574,6689,257428
4320,2020-09-16T17:00:00,ITA,20,Sardegna,39.21531192,9.110616306,88,17,105,1375,1480,27,1371,140,2991,138426
4321,2020-09-16T17:00:00,ITA,19,Sicilia,38.11569725,13.3623567,155,16,171,1817,1988,90,3190,295,5473,308515
4322,2020-09-16T17:00:00,ITA,9,Toscana,43.76923077,11.25588885,88,20,108,2480,2588,90,9565,1151,13304,433964
4323,2020-09-16T17:00:00,ITA,10,Umbria,43.10675841,12.38824698,27,5,32,436,468,17,1568,81,2117,109462
4324,2020-09-16T17:00:00,ITA,2,Valle d'Aosta,45.73750286,7.320149366,5,0,5,37,42,1,1079,146,1267,18731
4325,2020-09-16T17:00:00,ITA,5,Veneto,45.43490485,12.33845213,107,14,121,2869,2990,159,19997,2151,25138,683212
4326,2020-09-17T17:00:00,ITA,13,Abruzzo,42.35122196,13.39843823,45,5,50,582,632,33,2978,473,4083,116740
4327,2020-09-17T17:00:00,ITA,17,Basilicata,40.63947052,15.80514834,6,1,7,159,166,5,434,28,628,64636
4328,2020-09-17T17:00:00,ITA,18,Calabria,38.90597598,16.59440194,26,4,30,375,405,16,1254,98,1757,178292
4329,2020-09-17T17:00:00,ITA,15,Campania,40.83956555,14.25084984,302,21,323,3984,4307,195,4970,455,9732,321975
4330,2020-09-17T17:00:00,ITA,8,Emilia-Romagna,44.49436681,11.3417208,178,21,199,4078,4277,110,25224,4471,33972,612312
4331,2020-09-17T17:00:00,ITA,6,Friuli Venezia Giulia,45.6494354,13.76813649,22,4,26,630,656,63,3268,349,4273,168808
4332,2020-09-17T17:00:00,ITA,12,Lazio,41.89277044,12.48366722,492,16,508,4775,5283,181,7617,889,13789,629051
4333,2020-09-17T17:00:00,ITA,7,Liguria,44.41149315,8.9326992,135,15,150,1208,1358,40,9227,1586,12171,148192
4334,2020-09-17T17:00:00,ITA,3,Lombardia,45.46679409,9.190347404,272,32,304,8630,8934,281,78240,16906,104080,1173781
4335,2020-09-17T17:00:00,ITA,11,Marche,43.61675973,13.5188753,20,2,22,560,582,37,6079,989,7650,135016
4336,2020-09-17T17:00:00,ITA,14,Molise,41.55774754,14.65916051,3,1,4,96,100,2,455,23,578,37023
4337,2020-09-17T17:00:00,ITA,21,P.A. Bolzano,46.49933453,11.35662422,15,2,17,309,326,15,2565,292,3183,82321
4338,2020-09-17T17:00:00,ITA,22,P.A. Trento,46.06893511,11.12123097,11,0,11,560,571,76,4673,405,5649,91333
4339,2020-09-17T17:00:00,ITA,1,Piemonte,45.0732745,7.680687483,136,6,142,2080,2222,70,27665,4153,34040,399601
4340,2020-09-17T17:00:00,ITA,16,Puglia,41.12559576,16.86736689,200,14,214,1701,1915,63,4262,575,6752,260264
4341,2020-09-17T17:00:00,ITA,20,Sardegna,39.21531192,9.110616306,84,17,101,1413,1514,51,1388,140,3042,140077
4342,2020-09-17T17:00:00,ITA,19,Sicilia,38.11569725,13.3623567,173,14,187,1856,2043,96,3231,295,5569,312007
4343,2020-09-17T17:00:00,ITA,9,Toscana,43.76923077,11.25588885,89,20,109,2541,2650,119,9621,1152,13423,439124
4344,2020-09-17T17:00:00,ITA,10,Umbria,43.10675841,12.38824698,25,5,30,437,467,22,1590,82,2139,110422
4345,2020-09-17T17:00:00,ITA,2,Valle d'Aosta,45.73750286,7.320149366,5,0,5,36,41,1,1081,146,1268,18904
4346,2020-09-17T17:00:00,ITA,5,Veneto,45.43490485,12.33845213,109,12,121,2843,2964,109,20132,2151,25247,687364
4347,2020-09-18T17:00:00,ITA,13,Abruzzo,42.35122196,13.39843823,48,5,53,626,679,54,2984,474,4137,117719
4348,2020-09-18T17:00:00,ITA,17,Basilicata,40.63947052,15.80514834,6,1,7,156,163,0,437,28,628,65074
4349,2020-09-18T17:00:00,ITA,18,Calabria,38.90597598,16.59440194,24,4,28,393,421,28,1266,98,1785,180069
4350,2020-09-18T17:00:00,ITA,15,Campania,40.83956555,14.25084984,318,20,338,4127,4465,208,5020,455,9940,328713
4351,2020-09-18T17:00:00,ITA,8,Emilia-Romagna,44.49436681,11.3417208,182,21,203,4166,4369,121,25252,4472,34093,616330
4352,2020-09-18T17:00:00,ITA,6,Friuli Venezia Giulia,45.6494354,13.76813649,22,4,26,646,672,39,3291,349,4312,169788
4353,2020-09-18T17:00:00,ITA,12,Lazio,41.89277044,12.48366722,459,17,476,4937,5413,193,7680,889,13982,637844
4354,2020-09-18T17:00:00,ITA,7,Liguria,44.41149315,8.9326992,141,16,157,1257,1414,158,9329,1586,12329,150104
4355,2020-09-18T17:00:00,ITA,3,Lombardia,45.46679409,9.190347404,284,32,316,8711,9027,224,78369,16908,104304,1184027
4356,2020-09-18T17:00:00,ITA,11,Marche,43.61675973,13.5188753,22,1,23,583,606,29,6084,989,7679,135887
4357,2020-09-18T17:00:00,ITA,14,Molise,41.55774754,14.65916051,3,1,4,96,100,3,458,23,581,37522
4358,2020-09-18T17:00:00,ITA,21,P.A. Bolzano,46.49933453,11.35662422,15,2,17,368,385,72,2578,292,3255,83325
4359,2020-09-18T17:00:00,ITA,22,P.A. Trento,46.06893511,11.12123097,12,0,12,546,558,18,4704,405,5667,91799
4360,2020-09-18T17:00:00,ITA,1,Piemonte,45.0732745,7.680687483,140,6,146,2116,2262,127,27752,4153,34167,401619
4361,2020-09-18T17:00:00,ITA,16,Puglia,41.12559576,16.86736689,200,12,212,1774,1986,84,4273,577,6836,263073
4362,2020-09-18T17:00:00,ITA,20,Sardegna,39.21531192,9.110616306,89,17,106,1461,1567,66,1400,141,3108,141571
4363,2020-09-18T17:00:00,ITA,19,Sicilia,38.11569725,13.3623567,179,15,194,1963,2157,179,3295,296,5748,316122
4364,2020-09-18T17:00:00,ITA,9,Toscana,43.76923077,11.25588885,95,21,116,2584,2700,99,9670,1152,13522,444645
4365,2020-09-18T17:00:00,ITA,10,Umbria,43.10675841,12.38824698,27,5,32,423,455,21,1623,82,2160,111396
4366,2020-09-18T17:00:00,ITA,2,Valle d'Aosta,45.73750286,7.320149366,6,0,6,43,49,8,1081,146,1276,18953
4367,2020-09-18T17:00:00,ITA,5,Veneto,45.43490485,12.33845213,115,8,123,2886,3009,176,20261,2153,25423,691678
4368,2020-09-19T17:00:00,ITA,13,Abruzzo,42.35122196,13.39843823,48,5,53,626,679,0,2984,474,4137,117719
4369,2020-09-19T17:00:00,ITA,17,Basilicata,40.63947052,15.80514834,6,1,7,158,165,3,438,28,631,65708
4370,2020-09-19T17:00:00,ITA,18,Calabria,38.90597598,16.59440194,27,4,31,414,445,25,1267,98,1810,181949
4371,2020-09-19T17:00:00,ITA,15,Campania,40.83956555,14.25084984,327,19,346,4227,4573,149,5060,456,10089,333778
4372,2020-09-19T17:00:00,ITA,8,Emilia-Romagna,44.49436681,11.3417208,174,19,193,4245,4438,133,25313,4474,34225,620451
4373,2020-09-19T17:00:00,ITA,6,Friuli Venezia Giulia,45.6494354,13.76813649,20,3,23,658,681,33,3314,350,4345,170885
4374,2020-09-19T17:00:00,ITA,12,Lazio,41.89277044,12.48366722,445,22,467,5071,5538,197,7751,890,14179,646453
4375,2020-09-19T17:00:00,ITA,7,Liguria,44.41149315,8.9326992,140,16,156,1277,1433,78,9386,1588,12407,151550
4376,2020-09-19T17:00:00,ITA,3,Lombardia,45.46679409,9.190347404,271,36,307,8628,8935,243,78695,16917,104547,1197038
4377,2020-09-19T17:00:00,ITA,11,Marche,43.61675973,13.5188753,23,2,25,596,621,24,6093,989,7703,136589
4378,2020-09-19T17:00:00,ITA,14,Molise,41.55774754,14.65916051,5,1,6,98,104,5,459,23,586,37847
4379,2020-09-19T17:00:00,ITA,21,P.A. Bolzano,46.49933453,11.35662422,15,2,17,388,405,26,2584,292,3281,84628
4380,2020-09-19T17:00:00,ITA,22,P.A. Trento,46.06893511,11.12123097,10,0,10,524,534,22,4750,405,5689,92546
4381,2020-09-19T17:00:00,ITA,1,Piemonte,45.0732745,7.680687483,140,6,146,2158,2304,74,27783,4154,34241,403513
4382,2020-09-19T17:00:00,ITA,16,Puglia,41.12559576,16.86736689,201,13,214,1874,2088,108,4278,578,6944,265618
4383,2020-09-19T17:00:00,ITA,20,Sardegna,39.21531192,9.110616306,91,18,109,1486,1595,59,1431,141,3167,143431
4384,2020-09-19T17:00:00,ITA,19,Sicilia,38.11569725,13.3623567,191,13,204,2028,2232,98,3318,296,5846,318845
4385,2020-09-19T17:00:00,ITA,9,Toscana,43.76923077,11.25588885,88,21,109,2718,2827,143,9686,1152,13665,450613
4386,2020-09-19T17:00:00,ITA,10,Umbria,43.10675841,12.38824698,27,4,31,440,471,32,1638,83,2192,112361
4387,2020-09-19T17:00:00,ITA,2,Valle d'Aosta,45.73750286,7.320149366,6,0,6,42,48,0,1082,146,1276,19040
4388,2020-09-19T17:00:00,ITA,5,Veneto,45.43490485,12.33845213,125,10,135,2910,3045,186,20406,2158,25609,697466
4389,2020-09-20T17:00:00,ITA,13,Abruzzo,42.35122196,13.39843823,48,5,53,626,679,0,2984,474,4137,117719
4390,2020-09-20T17:00:00,ITA,17,Basilicata,40.63947052,15.80514834,6,1,7,159,166,6,443,28,637,66035
4391,2020-09-20T17:00:00,ITA,18,Calabria,38.90597598,16.59440194,30,4,34,427,461,22,1273,98,1832,183581
4392,2020-09-20T17:00:00,ITA,15,Campania,40.83956555,14.25084984,344,22,366,4309,4675,171,5129,456,10260,339764
4393,2020-09-20T17:00:00,ITA,8,Emilia-Romagna,44.49436681,11.3417208,169,19,188,4341,4529,115,25335,4476,34340,625160
4394,2020-09-20T17:00:00,ITA,6,Friuli Venezia Giulia,45.6494354,13.76813649,19,4,23,663,686,32,3341,350,4377,171811
4395,2020-09-20T17:00:00,ITA,12,Lazio,41.89277044,12.48366722,422,23,445,5244,5689,165,7765,890,14344,655297
4396,2020-09-20T17:00:00,ITA,7,Liguria,44.41149315,8.9326992,136,15,151,1310,1461,85,9440,1591,12492,152634
4397,2020-09-20T17:00:00,ITA,3,Lombardia,45.46679409,9.190347404,264,38,302,8705,9007,211,78829,16922,104758,1206551
4398,2020-09-20T17:00:00,ITA,11,Marche,43.61675973,13.5188753,21,2,23,619,642,31,6103,989,7734,137510
4399,2020-09-20T17:00:00,ITA,14,Molise,41.55774754,14.65916051,4,1,5,99,104,1,460,23,587,38140
4400,2020-09-20T17:00:00,ITA,21,P.A. Bolzano,46.49933453,11.35662422,15,2,17,405,422,20,2587,292,3301,85316
4401,2020-09-20T17:00:00,ITA,22,P.A. Trento,46.06893511,11.12123097,13,0,13,544,557,45,4772,405,5734,93131
4402,2020-09-20T17:00:00,ITA,1,Piemonte,45.0732745,7.680687483,142,7,149,2177,2326,98,27859,4154,34339,407611
4403,2020-09-20T17:00:00,ITA,16,Puglia,41.12559576,16.86736689,199,11,210,1918,2128,50,4287,579,6994,267208
4404,2020-09-20T17:00:00,ITA,20,Sardegna,39.21531192,9.110616306,96,18,114,1551,1665,72,1433,141,3239,144511
4405,2020-09-20T17:00:00,ITA,19,Sicilia,38.11569725,13.3623567,194,13,207,2109,2316,116,3350,296,5962,321168
4406,2020-09-20T17:00:00,ITA,9,Toscana,43.76923077,11.25588885,86,23,109,2847,2956,147,9704,1152,13812,455978
4407,2020-09-20T17:00:00,ITA,10,Umbria,43.10675841,12.38824698,29,4,33,452,485,24,1648,83,2216,113041
4408,2020-09-20T17:00:00,ITA,2,Valle d'Aosta,45.73750286,7.320149366,4,0,4,47,51,3,1082,146,1279,19140
4409,2020-09-20T17:00:00,ITA,5,Veneto,45.43490485,12.33845213,124,10,134,2959,3093,173,20527,2162,25782,701455
4410,2020-09-21T17:00:00,ITA,13,Abruzzo,42.35122196,13.39843823,58,5,63,676,739,72,2995,475,4209,120157
4411,2020-09-21T17:00:00,ITA,17,Basilicata,40.63947052,15.80514834,7,1,8,155,163,1,447,28,638,66117
4412,2020-09-21T17:00:00,ITA,18,Calabria,38.90597598,16.59440194,30,4,34,434,468,12,1278,98,1844,184501
4413,2020-09-21T17:00:00,ITA,15,Campania,40.83956555,14.25084984,345,21,366,4531,4897,243,5149,457,10503,345005
4414,2020-09-21T17:00:00,ITA,8,Emilia-Romagna,44.49436681,11.3417208,167,23,190,4428,4618,116,25361,4477,34456,627269
4415,2020-09-21T17:00:00,ITA,6,Friuli Venezia Giulia,45.6494354,13.76813649,20,5,25,671,696,13,3344,350,4390,172262
4416,2020-09-21T17:00:00,ITA,12,Lazio,41.89277044,12.48366722,466,27,493,5347,5840,198,7807,895,14542,662743
4417,2020-09-21T17:00:00,ITA,7,Liguria,44.41149315,8.9326992,145,15,160,1365,1525,64,9440,1591,12556,153324
4418,2020-09-21T17:00:00,ITA,3,Lombardia,45.46679409,9.190347404,283,36,319,8757,9076,90,78849,16923,104848,1213246
4419,2020-09-21T17:00:00,ITA,11,Marche,43.61675973,13.5188753,24,2,26,624,650,17,6112,989,7751,137930
4420,2020-09-21T17:00:00,ITA,14,Molise,41.55774754,14.65916051,5,1,6,126,132,31,463,23,618,38386
4421,2020-09-21T17:00:00,ITA,21,P.A. Bolzano,46.49933453,11.35662422,16,1,17,423,440,20,2589,292,3321,85880
4422,2020-09-21T17:00:00,ITA,22,P.A. Trento,46.06893511,11.12123097,13,0,13,545,558,2,4773,405,5736,93200
4423,2020-09-21T17:00:00,ITA,1,Piemonte,45.0732745,7.680687483,143,7,150,2208,2358,57,27883,4155,34396,410265
4424,2020-09-21T17:00:00,ITA,16,Puglia,41.12559576,16.86736689,201,11,212,1977,2189,81,4306,580,7075,268745
4425,2020-09-21T17:00:00,ITA,20,Sardegna,39.21531192,9.110616306,98,20,118,1596,1714,64,1446,143,3303,145340
4426,2020-09-21T17:00:00,ITA,19,Sicilia,38.11569725,13.3623567,203,14,217,2131,2348,75,3390,299,6037,323104
4427,2020-09-21T17:00:00,ITA,9,Toscana,43.76923077,11.25588885,94,23,117,2901,3018,84,9726,1152,13896,459147
4428,2020-09-21T17:00:00,ITA,10,Umbria,43.10675841,12.38824698,25,4,29,439,468,5,1669,84,2221,113380
4429,2020-09-21T17:00:00,ITA,2,Valle d'Aosta,45.73750286,7.320149366,3,0,3,45,48,2,1087,146,1281,19210
4430,2020-09-21T17:00:00,ITA,5,Veneto,45.43490485,12.33845213,129,12,141,2993,3134,103,20589,2162,25885,703443
4431,2020-09-22T17:00:00,ITA,13,Abruzzo,42.35122196,13.39843823,54,5,59,683,742,18,3010,475,4227,120852
4432,2020-09-22T17:00:00,ITA,17,Basilicata,40.63947052,15.80514834,10,1,11,166,177,14,447,28,652,66694
4433,2020-09-22T17:00:00,ITA,18,Calabria,38.90597598,16.59440194,29,4,33,457,490,24,1280,98,1868,186032
4434,2020-09-22T17:00:00,ITA,15,Campania,40.83956555,14.25084984,360,23,383,4572,4955,156,5247,457,10659,345740
4435,2020-09-22T17:00:00,ITA,8,Emilia-Romagna,44.49436681,11.3417208,185,22,207,4426,4633,56,25400,4478,34511,631253
4436,2020-09-22T17:00:00,ITA,6,Friuli Venezia Giulia,45.6494354,13.76813649,21,5,26,677,703,14,3351,350,4404,173067
4437,2020-09-22T17:00:00,ITA,12,Lazio,41.89277044,12.48366722,482,31,513,5517,6030,238,7851,899,14780,669956
4438,2020-09-22T17:00:00,ITA,7,Liguria,44.41149315,8.9326992,148,17,165,1365,1530,105,9539,1592,12661,154818
4439,2020-09-22T17:00:00,ITA,3,Lombardia,45.46679409,9.190347404,294,34,328,8699,9027,182,79078,16925,105030,1225067
4440,2020-09-22T17:00:00,ITA,11,Marche,43.61675973,13.5188753,24,3,27,633,660,18,6120,989,7769,138616
4441,2020-09-22T17:00:00,ITA,14,Molise,41.55774754,14.65916051,5,1,6,125,131,2,466,23,620,38579
4442,2020-09-22T17:00:00,ITA,21,P.A. Bolzano,46.49933453,11.35662422,20,1,21,427,448,8,2589,292,3329,86311
4443,2020-09-22T17:00:00,ITA,22,P.A. Trento,46.06893511,11.12123097,13,0,13,535,548,25,4808,405,5761,93785
4444,2020-09-22T17:00:00,ITA,1,Piemonte,45.0732745,7.680687483,164,7,171,2222,2393,84,27931,4156,34480,411192
4445,2020-09-22T17:00:00,ITA,16,Puglia,41.12559576,16.86736689,204,10,214,1976,2190,67,4371,581,7142,271426
4446,2020-09-22T17:00:00,ITA,20,Sardegna,39.21531192,9.110616306,96,21,117,1606,1723,53,1490,143,3356,147183
4447,2020-09-22T17:00:00,ITA,19,Sicilia,38.11569725,13.3623567,224,15,239,2151,2390,108,3455,300,6145,327407
4448,2020-09-22T17:00:00,ITA,9,Toscana,43.76923077,11.25588885,98,21,119,2939,3058,74,9760,1152,13970,462715
4449,2020-09-22T17:00:00,ITA,10,Umbria,43.10675841,12.38824698,28,4,32,437,469,26,1694,84,2247,114754
4450,2020-09-22T17:00:00,ITA,2,Valle d'Aosta,45.73750286,7.320149366,4,0,4,45,49,1,1087,146,1282,19320
4451,2020-09-22T17:00:00,ITA,5,Veneto,45.43490485,12.33845213,141,14,155,2988,3143,119,20696,2165,26004,707232
4452,2020-09-23T17:00:00,ITA,13,Abruzzo,42.35122196,13.39843823,55,4,59,701,760,22,3012,477,4249,122050
4453,2020-09-23T17:00:00,ITA,17,Basilicata,40.63947052,15.80514834,12,1,13,179,192,17,449,28,669,67261
4454,2020-09-23T17:00:00,ITA,18,Calabria,38.90597598,16.59440194,27,4,31,474,505,19,1284,98,1887,187925
4455,2020-09-23T17:00:00,ITA,15,Campania,40.83956555,14.25084984,356,22,378,4689,5067,248,5383,457,10907,350063
4456,2020-09-23T17:00:00,ITA,8,Emilia-Romagna,44.49436681,11.3417208,187,20,207,4406,4613,101,25520,4479,34612,636603
4457,2020-09-23T17:00:00,ITA,6,Friuli Venezia Giulia,45.6494354,13.76813649,16,6,22,688,710,57,3401,350,4461,174659
4458,2020-09-23T17:00:00,ITA,12,Lazio,41.89277044,12.48366722,521,32,553,5631,6184,195,7889,902,14975,678371
4459,2020-09-23T17:00:00,ITA,7,Liguria,44.41149315,8.9326992,149,18,167,1426,1593,108,9582,1594,12769,156756
4460,2020-09-23T17:00:00,ITA,3,Lombardia,45.46679409,9.190347404,308,33,341,8763,9104,196,79197,16925,105226,1239028
4461,2020-09-23T17:00:00,ITA,11,Marche,43.61675973,13.5188753,24,4,28,658,686,32,6126,989,7801,139445
4462,2020-09-23T17:00:00,ITA,14,Molise,41.55774754,14.65916051,3,1,4,128,132,3,468,23,623,39092
4463,2020-09-23T17:00:00,ITA,21,P.A. Bolzano,46.49933453,11.35662422,20,1,21,455,476,37,2598,292,3366,86974
4464,2020-09-23T17:00:00,ITA,22,P.A. Trento,46.06893511,11.12123097,13,0,13,547,560,22,4818,405,5783,94533
4465,2020-09-23T17:00:00,ITA,1,Piemonte,45.0732745,7.680687483,163,8,171,2247,2418,95,28000,4157,34575,413848
4466,2020-09-23T17:00:00,ITA,16,Puglia,41.12559576,16.86736689,204,10,214,2008,2222,89,4426,583,7231,274285
4467,2020-09-23T17:00:00,ITA,20,Sardegna,39.21531192,9.110616306,100,21,121,1624,1745,49,1515,145,3405,149069
4468,2020-09-23T17:00:00,ITA,19,Sicilia,38.11569725,13.3623567,230,16,246,2166,2412,89,3519,303,6234,331383
4469,2020-09-23T17:00:00,ITA,9,Toscana,43.76923077,11.25588885,97,24,121,2933,3054,90,9853,1153,14060,467414
4470,2020-09-23T17:00:00,ITA,10,Umbria,43.10675841,12.38824698,30,3,33,435,468,19,1713,85,2266,115748
4471,2020-09-23T17:00:00,ITA,2,Valle d'Aosta,45.73750286,7.320149366,4,0,4,54,58,2,1080,146,1284,19381
4472,2020-09-23T17:00:00,ITA,5,Veneto,45.43490485,12.33845213,139,16,155,3000,3155,150,20832,2167,26154,711874
4473,2020-09-24T17:00:00,ITA,13,Abruzzo,42.35122196,13.39843823,50,4,54,716,770,17,3019,477,4266,123127
4474,2020-09-24T17:00:00,ITA,17,Basilicata,40.63947052,15.80514834,13,1,14,182,196,9,454,28,678,68007
4475,2020-09-24T17:00:00,ITA,18,Calabria,38.90597598,16.59440194,29,4,33,467,500,9,1298,98,1896,189767
4476,2020-09-24T17:00:00,ITA,15,Campania,40.83956555,14.25084984,371,25,396,4761,5157,195,5488,457,11102,355075
4477,2020-09-24T17:00:00,ITA,8,Emilia-Romagna,44.49436681,11.3417208,192,20,212,4415,4627,99,25604,4480,34711,643017
4478,2020-09-24T17:00:00,ITA,6,Friuli Venezia Giulia,45.6494354,13.76813649,21,6,27,680,707,28,3432,350,4489,175810
4479,2020-09-24T17:00:00,ITA,12,Lazio,41.89277044,12.48366722,544,35,579,5768,6347,230,7956,902,15205,686623
4480,2020-09-24T17:00:00,ITA,7,Liguria,44.41149315,8.9326992,153,18,171,1483,1654,102,9621,1596,12871,158350
4481,2020-09-24T17:00:00,ITA,3,Lombardia,45.46679409,9.190347404,303,31,334,8714,9048,229,79472,16935,105455,1252897
4482,2020-09-24T17:00:00,ITA,11,Marche,43.61675973,13.5188753,25,3,28,672,700,17,6129,989,7818,140335
4483,2020-09-24T17:00:00,ITA,14,Molise,41.55774754,14.65916051,3,1,4,129,133,4,471,23,627,39412
4484,2020-09-24T17:00:00,ITA,21,P.A. Bolzano,46.49933453,11.35662422,20,1,21,464,485,20,2609,292,3386,87710
4485,2020-09-24T17:00:00,ITA,22,P.A. Trento,46.06893511,11.12123097,14,0,14,535,549,23,4852,405,5806,94954
4486,2020-09-24T17:00:00,ITA,1,Piemonte,45.0732745,7.680687483,165,9,174,2288,2462,104,28059,4158,34679,417396
4487,2020-09-24T17:00:00,ITA,16,Puglia,41.12559576,16.86736689,207,10,217,2046,2263,73,4455,586,7304,276895
4488,2020-09-24T17:00:00,ITA,20,Sardegna,39.21531192,9.110616306,112,18,130,1632,1762,66,1561,148,3471,151015
4489,2020-09-24T17:00:00,ITA,19,Sicilia,38.11569725,13.3623567,237,16,253,2208,2461,125,3594,304,6359,334504
4490,2020-09-24T17:00:00,ITA,9,Toscana,43.76923077,11.25588885,95,24,119,3037,3156,156,9907,1153,14216,472376
4491,2020-09-24T17:00:00,ITA,10,Umbria,43.10675841,12.38824698,30,3,33,442,475,29,1735,85,2295,116814
4492,2020-09-24T17:00:00,ITA,2,Valle d'Aosta,45.73750286,7.320149366,3,0,3,53,56,3,1085,146,1287,19525
4493,2020-09-24T17:00:00,ITA,5,Veneto,45.43490485,12.33845213,144,17,161,3111,3272,248,20961,2169,26402,717052
4494,2020-09-25T17:00:00,ITA,13,Abruzzo,42.35122196,13.39843823,58,5,63,754,817,51,3023,477,4317,124138
4495,2020-09-25T17:00:00,ITA,17,Basilicata,40.63947052,15.80514834,13,1,14,191,205,13,458,28,691,68857
4496,2020-09-25T17:00:00,ITA,18,Calabria,38.90597598,16.59440194,32,3,35,473,508,10,1300,98,1906,191675
4497,2020-09-25T17:00:00,ITA,15,Campania,40.83956555,14.25084984,382,27,409,4849,5258,253,5638,459,11355,362048
4498,2020-09-25T17:00:00,ITA,8,Emilia-Romagna,44.49436681,11.3417208,189,18,207,4444,4651,122,25701,4481,34833,647139
4499,2020-09-25T17:00:00,ITA,6,Friuli Venezia Giulia,45.6494354,13.76813649,17,6,23,690,713,37,3463,350,4526,177070
4500,2020-09-25T17:00:00,ITA,12,Lazio,41.89277044,12.48366722,563,36,599,5892,6491,230,8040,904,15435,695956
4501,2020-09-25T17:00:00,ITA,7,Liguria,44.41149315,8.9326992,145,17,162,1564,1726,73,9621,1597,12944,159717
4502,2020-09-25T17:00:00,ITA,3,Lombardia,45.46679409,9.190347404,300,30,330,8841,9171,277,79624,16937,105732,1265754
4503,2020-09-25T17:00:00,ITA,11,Marche,43.61675973,13.5188753,22,2,24,697,721,33,6140,990,7851,141222
4504,2020-09-25T17:00:00,ITA,14,Molise,41.55774754,14.65916051,3,1,4,129,133,5,476,23,632,39893
4505,2020-09-25T17:00:00,ITA,21,P.A. Bolzano,46.49933453,11.35662422,20,1,21,493,514,52,2632,292,3438,88792
4506,2020-09-25T17:00:00,ITA,22,P.A. Trento,46.06893511,11.12123097,13,0,13,535,548,23,4876,405,5829,95829
4507,2020-09-25T17:00:00,ITA,1,Piemonte,45.0732745,7.680687483,163,9,172,2330,2502,120,28138,4159,34799,420303
4508,2020-09-25T17:00:00,ITA,16,Puglia,41.12559576,16.86736689,208,10,218,2091,2309,90,4498,587,7394,279402
4509,2020-09-25T17:00:00,ITA,20,Sardegna,39.21531192,9.110616306,112,19,131,1653,1784,57,1596,148,3528,152652
4510,2020-09-25T17:00:00,ITA,19,Sicilia,38.11569725,13.3623567,235,13,248,2282,2530,107,3630,306,6466,337774
4511,2020-09-25T17:00:00,ITA,9,Toscana,43.76923077,11.25588885,87,24,111,3150,3261,139,9938,1156,14355,477064
4512,2020-09-25T17:00:00,ITA,10,Umbria,43.10675841,12.38824698,32,3,35,450,485,23,1748,85,2318,117862
4513,2020-09-25T17:00:00,ITA,2,Valle d'Aosta,45.73750286,7.320149366,3,0,3,52,55,1,1087,146,1288,19587
4514,2020-09-25T17:00:00,ITA,5,Veneto,45.43490485,12.33845213,140,19,159,3177,3336,196,21089,2173,26598,721936
4515,2020-09-26T17:00:00,ITA,13,Abruzzo,42.35122196,13.39843823,54,5,59,762,821,16,3035,477,4333,124985
4516,2020-09-26T17:00:00,ITA,17,Basilicata,40.63947052,15.80514834,14,1,15,214,229,25,459,28,716,69687
4517,2020-09-26T17:00:00,ITA,18,Calabria,38.90597598,16.59440194,30,2,32,481,513,15,1308,100,1921,193439
4518,2020-09-26T17:00:00,ITA,15,Campania,40.83956555,14.25084984,325,29,354,5127,5481,274,5688,460,11629,367291
4519,2020-09-26T17:00:00,ITA,8,Emilia-Romagna,44.49436681,11.3417208,200,17,217,4500,4717,99,25734,4481,34932,651887
4520,2020-09-26T17:00:00,ITA,6,Friuli Venezia Giulia,45.6494354,13.76813649,18,6,24,694,718,54,3512,350,4580,178499
4521,2020-09-26T17:00:00,ITA,12,Lazio,41.89277044,12.48366722,591,35,626,6041,6667,219,8081,906,15654,703206
4522,2020-09-26T17:00:00,ITA,7,Liguria,44.41149315,8.9326992,136,19,155,1582,1737,97,9705,1599,13041,161282
4523,2020-09-26T17:00:00,ITA,3,Lombardia,45.46679409,9.190347404,312,30,342,8745,9087,256,79960,16941,105988,1278033
4524,2020-09-26T17:00:00,ITA,11,Marche,43.61675973,13.5188753,23,2,25,716,741,26,6146,990,7877,142155
4525,2020-09-26T17:00:00,ITA,14,Molise,41.55774754,14.65916051,4,1,5,130,135,5,479,23,637,40259
4526,2020-09-26T17:00:00,ITA,21,P.A. Bolzano,46.49933453,11.35662422,26,0,26,514,540,29,2635,292,3467,89488
4527,2020-09-26T17:00:00,ITA,22,P.A. Trento,46.06893511,11.12123097,14,0,14,549,563,51,4912,405,5880,96818
4528,2020-09-26T17:00:00,ITA,1,Piemonte,45.0732745,7.680687483,164,10,174,2389,2563,107,28183,4160,34906,423689
4529,2020-09-26T17:00:00,ITA,16,Puglia,41.12559576,16.86736689,203,11,214,2123,2337,51,4518,590,7445,282195
4530,2020-09-26T17:00:00,ITA,20,Sardegna,39.21531192,9.110616306,109,18,127,1709,1836,63,1607,148,3591,154219
4531,2020-09-26T17:00:00,ITA,19,Sicilia,38.11569725,13.3623567,255,13,268,2315,2583,110,3687,306,6576,342008
4532,2020-09-26T17:00:00,ITA,9,Toscana,43.76923077,11.25588885,84,24,108,3219,3327,110,9981,1157,14465,481455
4533,2020-09-26T17:00:00,ITA,10,Umbria,43.10675841,12.38824698,34,3,37,463,500,35,1768,85,2353,118947
4534,2020-09-26T17:00:00,ITA,2,Valle d'Aosta,45.73750286,7.320149366,3,0,3,63,66,11,1087,146,1299,19697
4535,2020-09-26T17:00:00,ITA,5,Veneto,45.43490485,12.33845213,147,21,168,3264,3432,216,21208,2174,26814,727456
4536,2020-09-27T17:00:00,ITA,13,Abruzzo,42.35122196,13.39843823,50,5,55,807,862,47,3040,478,4380,126265
4537,2020-09-27T17:00:00,ITA,17,Basilicata,40.63947052,15.80514834,13,1,14,252,266,47,468,29,763,70206
4538,2020-09-27T17:00:00,ITA,18,Calabria,38.90597598,16.59440194,35,2,37,507,544,31,1308,100,1952,195309
4539,2020-09-27T17:00:00,ITA,15,Campania,40.83956555,14.25084984,400,30,430,5160,5590,245,5824,460,11874,371640
4540,2020-09-27T17:00:00,ITA,8,Emilia-Romagna,44.49436681,11.3417208,201,15,216,4466,4682,96,25864,4482,35028,655624
4541,2020-09-27T17:00:00,ITA,6,Friuli Venezia Giulia,45.6494354,13.76813649,18,6,24,696,720,28,3537,351,4608,179595
4542,2020-09-27T17:00:00,ITA,12,Lazio,41.89277044,12.48366722,610,38,648,6161,6809,181,8119,907,15835,710057
4543,2020-09-27T17:00:00,ITA,7,Liguria,44.41149315,8.9326992,137,22,159,1579,1738,45,9749,1599,13086,162174
4544,2020-09-27T17:00:00,ITA,3,Lombardia,45.46679409,9.190347404,302,31,333,8904,9237,216,80021,16946,106204,1288690
4545,2020-09-27T17:00:00,ITA,11,Marche,43.61675973,13.5188753,20,2,22,738,760,24,6151,990,7901,143076
4546,2020-09-27T17:00:00,ITA,14,Molise,41.55774754,14.65916051,2,1,3,138,141,7,479,24,644,40403
4547,2020-09-27T17:00:00,ITA,21,P.A. Bolzano,46.49933453,11.35662422,26,0,26,521,547,22,2650,292,3489,90172
4548,2020-09-27T17:00:00,ITA,22,P.A. Trento,46.06893511,11.12123097,12,0,12,586,598,42,4919,405,5922,97509
4549,2020-09-27T17:00:00,ITA,1,Piemonte,45.0732745,7.680687483,166,10,176,2457,2633,132,28244,4161,35038,426733
4550,2020-09-27T17:00:00,ITA,16,Puglia,41.12559576,16.86736689,210,12,222,2182,2404,76,4527,590,7521,283877
4551,2020-09-27T17:00:00,ITA,20,Sardegna,39.21531192,9.110616306,110,18,128,1836,1964,139,1617,149,3730,156237
4552,2020-09-27T17:00:00,ITA,19,Sicilia,38.11569725,13.3623567,268,14,282,2377,2659,107,3716,308,6683,345016
4553,2020-09-27T17:00:00,ITA,9,Toscana,43.76923077,11.25588885,82,23,105,3302,3407,101,10002,1157,14566,486576
4554,2020-09-27T17:00:00,ITA,10,Umbria,43.10675841,12.38824698,33,3,36,465,501,21,1788,85,2374,120300
4555,2020-09-27T17:00:00,ITA,2,Valle d'Aosta,45.73750286,7.320149366,3,0,3,63,66,0,1087,146,1299,19826
4556,2020-09-27T17:00:00,ITA,5,Veneto,45.43490485,12.33845213,148,21,169,3321,3490,159,21307,2176,26973,731147
4557,2020-09-28T17:00:00,ITA,13,Abruzzo,42.35122196,13.39843823,54,4,58,799,857,4,3048,479,4384,126392
4558,2020-09-28T17:00:00,ITA,17,Basilicata,40.63947052,15.80514834,13,1,14,259,273,7,468,29,770,70392
4559,2020-09-28T17:00:00,ITA,18,Calabria,38.90597598,16.59440194,36,2,38,508,546,5,1311,100,1957,196284
4560,2020-09-28T17:00:00,ITA,15,Campania,40.83956555,14.25084984,412,30,442,5298,5740,295,5968,461,12169,374216
4561,2020-09-28T17:00:00,ITA,8,Emilia-Romagna,44.49436681,11.3417208,201,15,216,4469,4685,85,25946,4482,35113,658254
4562,2020-09-28T17:00:00,ITA,6,Friuli Venezia Giulia,45.6494354,13.76813649,18,6,24,697,721,2,3538,351,4610,179938
4563,2020-09-28T17:00:00,ITA,12,Lazio,41.89277044,12.48366722,640,41,681,6240,6921,211,8215,910,16046,716730
4564,2020-09-28T17:00:00,ITA,7,Liguria,44.41149315,8.9326992,145,24,169,1601,1770,109,9825,1600,13195,163180
4565,2020-09-28T17:00:00,ITA,3,Lombardia,45.46679409,9.190347404,306,31,337,8997,9334,119,80041,16948,106323,1293542
4566,2020-09-28T17:00:00,ITA,11,Marche,43.61675973,13.5188753,25,4,29,733,762,5,6154,990,7906,143293
4567,2020-09-28T17:00:00,ITA,14,Molise,41.55774754,14.65916051,4,1,5,132,137,4,487,24,648,41105
4568,2020-09-28T17:00:00,ITA,21,P.A. Bolzano,46.49933453,11.35662422,26,0,26,534,560,25,2662,292,3514,90576
4569,2020-09-28T17:00:00,ITA,22,P.A. Trento,46.06893511,11.12123097,11,0,11,604,615,20,4921,406,5942,97622
4570,2020-09-28T17:00:00,ITA,1,Piemonte,45.0732745,7.680687483,180,12,192,2492,2684,94,28287,4161,35132,428535
4571,2020-09-28T17:00:00,ITA,16,Puglia,41.12559576,16.86736689,214,15,229,2190,2419,90,4600,592,7611,285597
4572,2020-09-28T17:00:00,ITA,20,Sardegna,39.21531192,9.110616306,109,17,126,1843,1969,37,1648,150,3767,157411
4573,2020-09-28T17:00:00,ITA,19,Sicilia,38.11569725,13.3623567,294,15,309,2434,2743,102,3733,309,6785,346506
4574,2020-09-28T17:00:00,ITA,9,Toscana,43.76923077,11.25588885,93,22,115,3278,3393,85,10098,1160,14651,489436
4575,2020-09-28T17:00:00,ITA,10,Umbria,43.10675841,12.38824698,38,3,41,467,508,11,1792,85,2385,120628
4576,2020-09-28T17:00:00,ITA,2,Valle d'Aosta,45.73750286,7.320149366,3,0,3,62,65,1,1089,146,1300,19888
4577,2020-09-28T17:00:00,ITA,5,Veneto,45.43490485,12.33845213,155,21,176,3445,3621,183,21359,2176,27156,733252
4578,2020-09-29T17:00:00,ITA,13,Abruzzo,42.35122196,13.39843823,52,4,56,809,865,14,3051,481,4397,126999
4579,2020-09-29T17:00:00,ITA,17,Basilicata,40.63947052,15.80514834,13,1,14,262,276,6,471,29,776,71333
4580,2020-09-29T17:00:00,ITA,18,Calabria,38.90597598,16.59440194,34,2,36,508,544,10,1323,100,1967,197671
4581,2020-09-29T17:00:00,ITA,15,Campania,40.83956555,14.25084984,417,35,452,5513,5965,286,6027,463,12455,378937
4582,2020-09-29T17:00:00,ITA,8,Emilia-Romagna,44.49436681,11.3417208,204,14,218,4492,4710,97,26016,4484,35210,662825
4583,2020-09-29T17:00:00,ITA,6,Friuli Venezia Giulia,45.6494354,13.76813649,21,6,27,697,724,28,3563,351,4638,180925
4584,2020-09-29T17:00:00,ITA,12,Lazio,41.89277044,12.48366722,674,45,719,6330,7049,219,8303,913,16265,724000
4585,2020-09-29T17:00:00,ITA,7,Liguria,44.41149315,8.9326992,143,22,165,1553,1718,89,9963,1603,13284,164500
4586,2020-09-29T17:00:00,ITA,3,Lombardia,45.46679409,9.190347404,315,33,348,8751,9099,203,80476,16951,106526,1303500
4587,2020-09-29T17:00:00,ITA,11,Marche,43.61675973,13.5188753,26,3,29,752,781,26,6161,990,7932,144152
4588,2020-09-29T17:00:00,ITA,14,Molise,41.55774754,14.65916051,5,1,6,129,135,1,490,24,649,41224
4589,2020-09-29T17:00:00,ITA,21,P.A. Bolzano,46.49933453,11.35662422,28,0,28,538,566,8,2664,292,3522,91062
4590,2020-09-29T17:00:00,ITA,22,P.A. Trento,46.06893511,11.12123097,11,0,11,576,587,13,4962,406,5955,98077
4591,2020-09-29T17:00:00,ITA,1,Piemonte,45.0732745,7.680687483,193,12,205,2527,2732,100,28337,4163,35232,431233
4592,2020-09-29T17:00:00,ITA,16,Puglia,41.12559576,16.86736689,210,14,224,2209,2433,76,4662,592,7687,288503
4593,2020-09-29T17:00:00,ITA,20,Sardegna,39.21531192,9.110616306,102,19,121,1910,2031,82,1667,151,3849,158909
4594,2020-09-29T17:00:00,ITA,19,Sicilia,38.11569725,13.3623567,293,16,309,2478,2787,163,3851,310,6948,350664
4595,2020-09-29T17:00:00,ITA,9,Toscana,43.76923077,11.25588885,97,20,117,3251,3368,56,10175,1164,14707,492445
4596,2020-09-29T17:00:00,ITA,10,Umbria,43.10675841,12.38824698,39,3,42,478,520,23,1803,85,2408,121933
4597,2020-09-29T17:00:00,ITA,2,Valle d'Aosta,45.73750286,7.320149366,4,0,4,65,69,8,1093,146,1308,19979
4598,2020-09-29T17:00:00,ITA,5,Veneto,45.43490485,12.33845213,167,21,188,3483,3671,140,21448,2177,27296,737524
4599,2020-09-30T17:00:00,ITA,13,Abruzzo,42.35122196,13.39843823,52,5,57,824,881,23,3057,481,4419,128012
4600,2020-09-30T17:00:00,ITA,17,Basilicata,40.63947052,15.80514834,11,2,13,294,307,32,472,29,808,72216
4601,2020-09-30T17:00:00,ITA,18,Calabria,38.90597598,16.59440194,33,2,35,520,555,18,1330,100,1985,199568
4602,2020-09-30T17:00:00,ITA,15,Campania,40.83956555,14.25084984,414,39,453,5660,6113,287,6166,463,12742,383899
4603,2020-09-30T17:00:00,ITA,8,Emilia-Romagna,44.49436681,11.3417208,205,14,219,4434,4653,101,26174,4484,35311,667137
4604,2020-09-30T17:00:00,ITA,6,Friuli Venezia Giulia,45.6494354,13.76813649,19,6,25,693,718,28,3597,351,4666,182145
4605,2020-09-30T17:00:00,ITA,12,Lazio,41.89277044,12.48366722,659,47,706,6442,7148,210,8409,918,16475,732123
4606,2020-09-30T17:00:00,ITA,7,Liguria,44.41149315,8.9326992,143,22,165,1574,1739,51,9992,1604,13335,166142
4607,2020-09-30T17:00:00,ITA,3,Lombardia,45.46679409,9.190347404,306,34,340,8720,9060,201,80712,16955,106727,1315230
4608,2020-09-30T17:00:00,ITA,11,Marche,43.61675973,13.5188753,28,2,30,765,795,23,6170,990,7955,144940
4609,2020-09-30T17:00:00,ITA,14,Molise,41.55774754,14.65916051,4,0,4,129,133,6,498,24,655,41728
4610,2020-09-30T17:00:00,ITA,21,P.A. Bolzano,46.49933453,11.35662422,28,0,28,533,561,17,2686,292,3539,91761
4611,2020-09-30T17:00:00,ITA,22,P.A. Trento,46.06893511,11.12123097,14,0,14,553,567,37,5019,406,5992,99092
4612,2020-09-30T17:00:00,ITA,1,Piemonte,45.0732745,7.680687483,196,12,208,2636,2844,170,28394,4164,35402,434855
4613,2020-09-30T17:00:00,ITA,16,Puglia,41.12559576,16.86736689,218,11,229,2287,2516,99,4675,595,7786,291519
4614,2020-09-30T17:00:00,ITA,20,Sardegna,39.21531192,9.110616306,101,19,120,1941,2061,51,1685,154,3900,161097
4615,2020-09-30T17:00:00,ITA,19,Sicilia,38.11569725,13.3623567,301,19,320,2546,2866,170,3941,311,7118,354475
4616,2020-09-30T17:00:00,ITA,9,Toscana,43.76923077,11.25588885,97,22,119,3283,3402,120,10261,1164,14827,497351
4617,2020-09-30T17:00:00,ITA,10,Umbria,43.10675841,12.38824698,39,3,42,495,537,46,1832,85,2454,122979
4618,2020-09-30T17:00:00,ITA,2,Valle d'Aosta,45.73750286,7.320149366,6,0,6,69,75,6,1093,146,1314,20125
4619,2020-09-30T17:00:00,ITA,5,Veneto,45.43490485,12.33845213,173,21,194,3538,3732,155,21541,2178,27451,742361
4620,2020-10-01T17:00:00,ITA,13,Abruzzo,42.35122196,13.39843823,52,5,57,852,909,30,3059,481,4449,129248
4621,2020-10-01T17:00:00,ITA,17,Basilicata,40.63947052,15.80514834,11,2,13,325,338,33,474,29,841,73155
4622,2020-10-01T17:00:00,ITA,18,Calabria,38.90597598,16.59440194,32,2,34,503,537,17,1365,100,2002,201540
4623,2020-10-01T17:00:00,ITA,15,Campania,40.83956555,14.25084984,421,38,459,5937,6396,390,6273,463,13132,391374
4624,2020-10-01T17:00:00,ITA,8,Emilia-Romagna,44.49436681,11.3417208,206,14,220,4434,4654,103,26276,4484,35414,670418
4625,2020-10-01T17:00:00,ITA,6,Friuli Venezia Giulia,45.6494354,13.76813649,20,4,24,735,759,57,3613,351,4723,183898
4626,2020-10-01T17:00:00,ITA,12,Lazio,41.89277044,12.48366722,666,49,715,6628,7343,265,8474,923,16740,740268
4627,2020-10-01T17:00:00,ITA,7,Liguria,44.41149315,8.9326992,152,21,173,1598,1771,111,10067,1608,13446,167855
4628,2020-10-01T17:00:00,ITA,3,Lombardia,45.46679409,9.190347404,298,35,333,8834,9167,324,80924,16960,107051,1331274
4629,2020-10-01T17:00:00,ITA,11,Marche,43.61675973,13.5188753,24,6,30,783,813,28,6180,990,7983,145986
4630,2020-10-01T17:00:00,ITA,14,Molise,41.55774754,14.65916051,4,0,4,130,134,1,498,24,656,41971
4631,2020-10-01T17:00:00,ITA,21,P.A. Bolzano,46.49933453,11.35662422,28,0,28,554,582,29,2694,292,3568,92681
4632,2020-10-01T17:00:00,ITA,22,P.A. Trento,46.06893511,11.12123097,15,0,15,579,594,48,5040,406,6040,99722
4633,2020-10-01T17:00:00,ITA,1,Piemonte,45.0732745,7.680687483,203,12,215,2692,2907,110,28440,4165,35512,436125
4634,2020-10-01T17:00:00,ITA,16,Puglia,41.12559576,16.86736689,217,14,231,2376,2607,114,4697,596,7900,294298
4635,2020-10-01T17:00:00,ITA,20,Sardegna,39.21531192,9.110616306,110,20,130,2006,2136,96,1705,155,3996,162894
4636,2020-10-01T17:00:00,ITA,19,Sicilia,38.11569725,13.3623567,307,20,327,2609,2936,156,4026,312,7274,358336
4637,2020-10-01T17:00:00,ITA,9,Toscana,43.76923077,11.25588885,106,22,128,3340,3468,144,10338,1165,14971,502556
4638,2020-10-01T17:00:00,ITA,10,Umbria,43.10675841,12.38824698,38,3,41,521,562,46,1853,85,2500,124094
4639,2020-10-01T17:00:00,ITA,2,Valle d'Aosta,45.73750286,7.320149366,7,0,7,62,69,1,1100,146,1315,20265
4640,2020-10-01T17:00:00,ITA,5,Veneto,45.43490485,12.33845213,180,24,204,3761,3965,445,21748,2183,27896,748630
4641,2020-10-02T17:00:00,ITA,13,Abruzzo,42.35122196,13.39843823,58,6,64,874,938,49,3079,481,4498,130591
4642,2020-10-02T17:00:00,ITA,17,Basilicata,40.63947052,15.80514834,11,2,13,332,345,16,482,30,857,74088
4643,2020-10-02T17:00:00,ITA,18,Calabria,38.90597598,16.59440194,34,1,35,503,538,18,1382,100,2020,203282
4644,2020-10-02T17:00:00,ITA,15,Campania,40.83956555,14.25084984,439,39,478,6267,6745,392,6315,464,13524,397526
4645,2020-10-02T17:00:00,ITA,8,Emilia-Romagna,44.49436681,11.3417208,201,11,212,4465,4677,163,26416,4484,35577,676766
4646,2020-10-02T17:00:00,ITA,6,Friuli Venezia Giulia,45.6494354,13.76813649,18,2,20,773,793,66,3643,353,4789,185748
4647,2020-10-02T17:00:00,ITA,12,Lazio,41.89277044,12.48366722,678,49,727,6820,7547,264,8529,928,17004,749852
4648,2020-10-02T17:00:00,ITA,7,Liguria,44.41149315,8.9326992,161,23,184,1645,1829,140,10149,1608,13586,169760
4649,2020-10-02T17:00:00,ITA,3,Lombardia,45.46679409,9.190347404,302,39,341,8825,9166,307,81228,16964,107358,1343544
4650,2020-10-02T17:00:00,ITA,11,Marche,43.61675973,13.5188753,25,4,29,815,844,42,6191,990,8025,147169
4651,2020-10-02T17:00:00,ITA,14,Molise,41.55774754,14.65916051,5,0,5,126,131,4,505,24,660,42437
4652,2020-10-02T17:00:00,ITA,21,P.A. Bolzano,46.49933453,11.35662422,28,0,28,559,587,21,2710,292,3589,93443
4653,2020-10-02T17:00:00,ITA,22,P.A. Trento,46.06893511,11.12123097,16,0,16,571,587,39,5086,406,6079,100451
4654,2020-10-02T17:00:00,ITA,1,Piemonte,45.0732745,7.680687483,217,13,230,2830,3060,219,28505,4166,35731,438901
4655,2020-10-02T17:00:00,ITA,16,Puglia,41.12559576,16.86736689,223,13,236,2427,2663,72,4712,597,7972,296760
4656,2020-10-02T17:00:00,ITA,20,Sardegna,39.21531192,9.110616306,106,21,127,2027,2154,60,1747,155,4056,164505
4657,2020-10-02T17:00:00,ITA,19,Sicilia,38.11569725,13.3623567,303,21,324,2724,3048,140,4052,314,7414,362142
4658,2020-10-02T17:00:00,ITA,9,Toscana,43.76923077,11.25588885,103,24,127,3504,3631,223,10398,1165,15194,508398
4659,2020-10-02T17:00:00,ITA,10,Umbria,43.10675841,12.38824698,39,4,43,567,610,62,1867,85,2562,125136
4660,2020-10-02T17:00:00,ITA,2,Valle d'Aosta,45.73750286,7.320149366,8,0,8,69,77,11,1103,146,1326,20378
4661,2020-10-02T17:00:00,ITA,5,Veneto,45.43490485,12.33845213,167,22,189,3838,4027,191,21871,2189,28087,757440
4662,2020-10-03T17:00:00,ITA,13,Abruzzo,42.35122196,13.39843823,66,6,72,890,962,42,3097,481,4540,131710
4663,2020-10-03T17:00:00,ITA,17,Basilicata,40.63947052,15.80514834,15,2,17,370,387,49,486,33,906,75517
4664,2020-10-03T17:00:00,ITA,18,Calabria,38.90597598,16.59440194,36,2,38,520,558,24,1386,100,2044,205184
4665,2020-10-03T17:00:00,ITA,15,Campania,40.83956555,14.25084984,434,40,474,6568,7042,401,6418,465,13925,403167
4666,2020-10-03T17:00:00,ITA,8,Emilia-Romagna,44.49436681,11.3417208,200,11,211,4579,4790,167,26468,4485,35743,680394
4667,2020-10-03T17:00:00,ITA,6,Friuli Venezia Giulia,45.6494354,13.76813649,17,5,22,806,828,51,3659,353,4840,187109
4668,2020-10-03T17:00:00,ITA,12,Lazio,41.89277044,12.48366722,711,47,758,6967,7725,261,8607,933,17265,759903
4669,2020-10-03T17:00:00,ITA,7,Liguria,44.41149315,8.9326992,167,21,188,1672,1860,162,10279,1609,13748,171959
4670,2020-10-03T17:00:00,ITA,3,Lombardia,45.46679409,9.190347404,293,42,335,8827,9162,393,81620,16969,107751,1355640
4671,2020-10-03T17:00:00,ITA,11,Marche,43.61675973,13.5188753,23,6,29,867,896,59,6197,991,8084,148490
4672,2020-10-03T17:00:00,ITA,14,Molise,41.55774754,14.65916051,3,0,3,125,128,0,507,25,660,42882
4673,2020-10-03T17:00:00,ITA,21,P.A. Bolzano,46.49933453,11.35662422,28,0,28,576,604,24,2717,292,3613,94145
4674,2020-10-03T17:00:00,ITA,22,P.A. Trento,46.06893511,11.12123097,16,0,16,602,618,62,5117,406,6141,101101
4675,2020-10-03T17:00:00,ITA,1,Piemonte,45.0732745,7.680687483,214,12,226,3051,3277,279,28567,4166,36010,442510
4676,2020-10-03T17:00:00,ITA,16,Puglia,41.12559576,16.86736689,226,12,238,2523,2761,111,4724,598,8083,299404
4677,2020-10-03T17:00:00,ITA,20,Sardegna,39.21531192,9.110616306,113,21,134,2052,2186,62,1777,155,4118,166214
4678,2020-10-03T17:00:00,ITA,19,Sicilia,38.11569725,13.3623567,322,20,342,2829,3171,182,4108,317,7596,366048
4679,2020-10-03T17:00:00,ITA,9,Toscana,43.76923077,11.25588885,99,24,123,3667,3790,197,10435,1166,15391,514176
4680,2020-10-03T17:00:00,ITA,10,Umbria,43.10675841,12.38824698,41,5,46,588,634,42,1885,85,2604,126315
4681,2020-10-03T17:00:00,ITA,2,Valle d'Aosta,45.73750286,7.320149366,7,0,7,68,75,0,1105,146,1326,20476
4682,2020-10-03T17:00:00,ITA,5,Veneto,45.43490485,12.33845213,174,21,195,3917,4112,276,22058,2193,28363,765605
4683,2020-10-04T17:00:00,ITA,13,Abruzzo,42.35122196,13.39843823,70,6,76,919,995,37,3101,481,4577,132948
4684,2020-10-04T17:00:00,ITA,17,Basilicata,40.63947052,15.80514834,15,2,17,373,390,14,497,33,920,75915
4685,2020-10-04T17:00:00,ITA,18,Calabria,38.90597598,16.59440194,36,2,38,537,575,19,1387,101,2063,206980
4686,2020-10-04T17:00:00,ITA,15,Campania,40.83956555,14.25084984,450,41,491,6909,7400,412,6472,465,14337,408931
4687,2020-10-04T17:00:00,ITA,8,Emilia-Romagna,44.49436681,11.3417208,212,11,223,4731,4954,179,26482,4486,35922,684859
4688,2020-10-04T17:00:00,ITA,6,Friuli Venezia Giulia,45.6494354,13.76813649,18,5,23,828,851,50,3686,353,4890,188339
4689,2020-10-04T17:00:00,ITA,12,Lazio,41.89277044,12.48366722,737,48,785,7148,7933,244,8637,939,17509,768942
4690,2020-10-04T17:00:00,ITA,7,Liguria,44.41149315,8.9326992,167,23,190,1687,1877,121,10382,1610,13869,173211
4691,2020-10-04T17:00:00,ITA,3,Lombardia,45.46679409,9.190347404,296,39,335,9026,9361,314,81733,16971,108065,1365206
4692,2020-10-04T17:00:00,ITA,11,Marche,43.61675973,13.5188753,24,6,30,911,941,59,6210,992,8143,149612
4693,2020-10-04T17:00:00,ITA,14,Molise,41.55774754,14.65916051,2,0,2,139,141,15,509,25,675,43376
4694,2020-10-04T17:00:00,ITA,21,P.A. Bolzano,46.49933453,11.35662422,28,0,28,588,616,32,2737,292,3645,94635
4695,2020-10-04T17:00:00,ITA,22,P.A. Trento,46.06893511,11.12123097,17,0,17,612,629,34,5140,406,6175,101675
4696,2020-10-04T17:00:00,ITA,1,Piemonte,45.0732745,7.680687483,216,13,229,3141,3370,173,28646,4167,36183,446474
4697,2020-10-04T17:00:00,ITA,16,Puglia,41.12559576,16.86736689,231,13,244,2653,2897,151,4739,598,8234,301067
4698,2020-10-04T17:00:00,ITA,20,Sardegna,39.21531192,9.110616306,114,20,134,2145,2279,111,1794,156,4229,167736
4699,2020-10-04T17:00:00,ITA,19,Sicilia,38.11569725,13.3623567,329,24,353,2894,3247,85,4115,319,7681,368405
4700,2020-10-04T17:00:00,ITA,9,Toscana,43.76923077,11.25588885,99,26,125,3837,3962,188,10451,1166,15579,519910
4701,2020-10-04T17:00:00,ITA,10,Umbria,43.10675841,12.38824698,42,4,46,649,695,72,1895,86,2676,127485
4702,2020-10-04T17:00:00,ITA,2,Valle d'Aosta,45.73750286,7.320149366,6,0,6,75,81,7,1106,146,1333,20588
4703,2020-10-04T17:00:00,ITA,5,Veneto,45.43490485,12.33845213,178,20,198,4037,4235,261,22195,2194,28624,771021
4704,2020-10-05T17:00:00,ITA,13,Abruzzo,42.35122196,13.39843823,72,7,79,938,1017,30,3108,482,4607,133682
4705,2020-10-05T17:00:00,ITA,17,Basilicata,40.63947052,15.80514834,30,2,32,371,403,14,498,33,934,76055
4706,2020-10-05T17:00:00,ITA,18,Calabria,38.90597598,16.59440194,37,2,39,544,583,23,1402,101,2086,208340
4707,2020-10-05T17:00:00,ITA,15,Campania,40.83956555,14.25084984,463,43,506,7203,7709,431,6593,466,14768,412392
4708,2020-10-05T17:00:00,ITA,8,Emilia-Romagna,44.49436681,11.3417208,213,11,224,4822,5046,167,26556,4487,36089,686918
4709,2020-10-05T17:00:00,ITA,6,Friuli Venezia Giulia,45.6494354,13.76813649,23,5,28,840,868,21,3690,353,4911,188881
4710,2020-10-05T17:00:00,ITA,12,Lazio,41.89277044,12.48366722,764,48,812,7330,8142,248,8671,944,17757,778041
4711,2020-10-05T17:00:00,ITA,7,Liguria,44.41149315,8.9326992,180,24,204,1703,1907,107,10459,1610,13976,174024
4712,2020-10-05T17:00:00,ITA,3,Lombardia,45.46679409,9.190347404,305,41,346,9186,9532,251,81811,16973,108316,1370079
4713,2020-10-05T17:00:00,ITA,11,Marche,43.61675973,13.5188753,28,6,34,920,954,22,6219,992,8165,150061
4714,2020-10-05T17:00:00,ITA,14,Molise,41.55774754,14.65916051,3,0,3,134,137,2,515,25,677,43575
4715,2020-10-05T17:00:00,ITA,21,P.A. Bolzano,46.49933453,11.35662422,21,0,21,606,627,17,2743,292,3662,94956
4716,2020-10-05T17:00:00,ITA,22,P.A. Trento,46.06893511,11.12123097,17,0,17,633,650,49,5168,406,6224,102111
4717,2020-10-05T17:00:00,ITA,1,Piemonte,45.0732745,7.680687483,273,15,288,3135,3423,129,28721,4168,36312,447344
4718,2020-10-05T17:00:00,ITA,16,Puglia,41.12559576,16.86736689,239,14,253,2703,2956,83,4762,599,8317,302788
4719,2020-10-05T17:00:00,ITA,20,Sardegna,39.21531192,9.110616306,116,19,135,2191,2326,88,1835,156,4317,169073
4720,2020-10-05T17:00:00,ITA,19,Sicilia,38.11569725,13.3623567,361,28,389,2969,3358,128,4130,321,7809,370087
4721,2020-10-05T17:00:00,ITA,9,Toscana,43.76923077,11.25588885,112,32,144,3921,4065,185,10531,1168,15764,523569
4722,2020-10-05T17:00:00,ITA,10,Umbria,43.10675841,12.38824698,42,5,47,659,706,19,1903,86,2695,127714
4723,2020-10-05T17:00:00,ITA,2,Valle d'Aosta,45.73750286,7.320149366,6,1,7,86,93,13,1107,146,1346,20687
4724,2020-10-05T17:00:00,ITA,5,Veneto,45.43490485,12.33845213,182,20,202,4199,4401,230,22259,2194,28854,773489
4725,2020-10-06T17:00:00,ITA,13,Abruzzo,42.35122196,13.39843823,81,6,87,971,1058,48,3113,484,4655,134677
4726,2020-10-06T17:00:00,ITA,17,Basilicata,40.63947052,15.80514834,30,2,32,371,403,4,502,33,938,77079
4727,2020-10-06T17:00:00,ITA,18,Calabria,38.90597598,16.59440194,38,1,39,546,585,23,1422,102,2109,210222
4728,2020-10-06T17:00:00,ITA,15,Campania,40.83956555,14.25084984,488,47,535,7442,7977,395,6718,468,15163,416074
4729,2020-10-06T17:00:00,ITA,8,Emilia-Romagna,44.49436681,11.3417208,212,13,225,4929,5154,172,26617,4490,36261,691551
4730,2020-10-06T17:00:00,ITA,6,Friuli Venezia Giulia,45.6494354,13.76813649,24,5,29,879,908,51,3699,355,4962,190029
4731,2020-10-06T17:00:00,ITA,12,Lazio,41.89277044,12.48366722,774,44,818,7472,8290,275,8794,948,18032,786768
4732,2020-10-06T17:00:00,ITA,7,Liguria,44.41149315,8.9326992,178,23,201,1724,1925,170,10609,1612,14146,175730
4733,2020-10-06T17:00:00,ITA,3,Lombardia,45.46679409,9.190347404,320,40,360,9149,9509,350,82184,16973,108666,1380719
4734,2020-10-06T17:00:00,ITA,11,Marche,43.61675973,13.5188753,29,6,35,947,982,35,6226,992,8200,150966
4735,2020-10-06T17:00:00,ITA,14,Molise,41.55774754,14.65916051,3,0,3,135,138,6,520,25,683,44119
4736,2020-10-06T17:00:00,ITA,21,P.A. Bolzano,46.49933453,11.35662422,21,0,21,609,630,17,2757,292,3679,95487
4737,2020-10-06T17:00:00,ITA,22,P.A. Trento,46.06893511,11.12123097,22,0,22,641,663,40,5195,406,6264,102600
4738,2020-10-06T17:00:00,ITA,1,Piemonte,45.0732745,7.680687483,293,15,308,3274,3582,259,28819,4170,36571,452847
4739,2020-10-06T17:00:00,ITA,16,Puglia,41.12559576,16.86736689,244,21,265,2726,2991,106,4829,603,8423,306067
4740,2020-10-06T17:00:00,ITA,20,Sardegna,39.21531192,9.110616306,125,19,144,2181,2325,63,1898,157,4380,170991
4741,2020-10-06T17:00:00,ITA,19,Sicilia,38.11569725,13.3623567,368,28,396,3052,3448,198,4237,322,8007,374604
4742,2020-10-06T17:00:00,ITA,9,Toscana,43.76923077,11.25588885,117,28,145,4054,4199,209,10606,1168,15973,528501
4743,2020-10-06T17:00:00,ITA,10,Umbria,43.10675841,12.38824698,45,5,50,698,748,62,1923,86,2757,129274
4744,2020-10-06T17:00:00,ITA,2,Valle d'Aosta,45.73750286,7.320149366,5,1,6,87,93,5,1112,146,1351,20774
4745,2020-10-06T17:00:00,ITA,5,Veneto,45.43490485,12.33845213,208,15,223,4303,4526,189,22319,2198,29043,777300
4746,2020-10-07T17:00:00,ITA,13,Abruzzo,42.35122196,13.39843823,88,6,94,1004,1098,61,3132,485,4715,136225
4747,2020-10-07T17:00:00,ITA,17,Basilicata,40.63947052,15.80514834,35,0,35,379,414,15,504,35,953,77839
4748,2020-10-07T17:00:00,ITA,18,Calabria,38.90597598,16.59440194,37,1,38,553,591,16,1432,102,2125,212223
4749,2020-10-07T17:00:00,ITA,15,Campania,40.83956555,14.25084984,520,52,572,7771,8343,544,6895,469,15707,422215
4750,2020-10-07T17:00:00,ITA,8,Emilia-Romagna,44.49436681,11.3417208,223,14,237,5058,5295,193,26668,4491,36454,698835
4751,2020-10-07T17:00:00,ITA,6,Friuli Venezia Giulia,45.6494354,13.76813649,26,6,32,913,945,72,3734,355,5034,192089
4752,2020-10-07T17:00:00,ITA,12,Lazio,41.89277044,12.48366722,808,48,856,7724,8580,357,8855,954,18389,795451
4753,2020-10-07T17:00:00,ITA,7,Liguria,44.41149315,8.9326992,196,24,220,1812,2032,176,10676,1614,14322,177511
4754,2020-10-07T17:00:00,ITA,3,Lombardia,45.46679409,9.190347404,339,40,379,9498,9877,520,82331,16978,109186,1395667
4755,2020-10-07T17:00:00,ITA,11,Marche,43.61675973,13.5188753,31,5,36,1016,1052,84,6240,992,8284,152490
4756,2020-10-07T17:00:00,ITA,14,Molise,41.55774754,14.65916051,4,0,4,134,138,1,521,25,684,44539
4757,2020-10-07T17:00:00,ITA,21,P.A. Bolzano,46.49933453,11.35662422,21,1,22,645,667,55,2775,292,3734,96289
4758,2020-10-07T17:00:00,ITA,22,P.A. Trento,46.06893511,11.12123097,18,0,18,631,649,32,5241,406,6296,102992
4759,2020-10-07T17:00:00,ITA,1,Piemonte,45.0732745,7.680687483,297,15,312,3412,3724,287,28962,4172,36858,456021
4760,2020-10-07T17:00:00,ITA,16,Puglia,41.12559576,16.86736689,251,23,274,2859,3133,196,4883,603,8619,309260
4761,2020-10-07T17:00:00,ITA,20,Sardegna,39.21531192,9.110616306,128,19,147,2243,2390,101,1931,160,4481,172673
4762,2020-10-07T17:00:00,ITA,19,Sicilia,38.11569725,13.3623567,375,30,405,3144,3549,213,4345,326,8220,378610
4763,2020-10-07T17:00:00,ITA,9,Toscana,43.76923077,11.25588885,123,28,151,4279,4430,300,10673,1170,16273,535058
4764,2020-10-07T17:00:00,ITA,10,Umbria,43.10675841,12.38824698,44,8,52,756,808,65,1928,86,2822,135552
4765,2020-10-07T17:00:00,ITA,2,Valle d'Aosta,45.73750286,7.320149366,4,1,5,102,107,15,1113,146,1366,20931
4766,2020-10-07T17:00:00,ITA,5,Veneto,45.43490485,12.33845213,214,16,230,4524,4754,375,22464,2200,29418,784296
4767,2020-10-08T17:00:00,ITA,13,Abruzzo,42.35122196,13.39843823,90,7,97,1055,1152,68,3145,486,4783,137364
4768,2020-10-08T17:00:00,ITA,17,Basilicata,40.63947052,15.80514834,35,0,35,394,429,22,511,35,975,78439
4769,2020-10-08T17:00:00,ITA,18,Calabria,38.90597598,16.59440194,39,1,40,563,603,21,1441,102,2146,214128
4770,2020-10-08T17:00:00,ITA,15,Campania,40.83956555,14.25084984,548,55,603,8347,8950,757,7044,470,16464,430106
4771,2020-10-08T17:00:00,ITA,8,Emilia-Romagna,44.49436681,11.3417208,232,13,245,5179,5424,184,26722,4492,36638,704510
4772,2020-10-08T17:00:00,ITA,6,Friuli Venezia Giulia,45.6494354,13.76813649,23,6,29,991,1020,110,3769,355,5144,194340
4773,2020-10-08T17:00:00,ITA,12,Lazio,41.89277044,12.48366722,821,55,876,7976,8852,359,8936,960,18748,805125
4774,2020-10-08T17:00:00,ITA,7,Liguria,44.41149315,8.9326992,195,28,223,1932,2155,152,10705,1614,14474,179543
4775,2020-10-08T17:00:00,ITA,3,Lombardia,45.46679409,9.190347404,361,41,402,10004,10406,683,82484,16979,109869,1408098
4776,2020-10-08T17:00:00,ITA,11,Marche,43.61675973,13.5188753,34,5,39,1068,1107,66,6251,992,8350,153648
4777,2020-10-08T17:00:00,ITA,14,Molise,41.55774754,14.65916051,6,0,6,136,142,6,523,25,690,45014
4778,2020-10-08T17:00:00,ITA,21,P.A. Bolzano,46.49933453,11.35662422,30,1,31,695,726,69,2785,292,3803,97393
4779,2020-10-08T17:00:00,ITA,22,P.A. Trento,46.06893511,11.12123097,18,0,18,672,690,59,5259,406,6355,103685
4780,2020-10-08T17:00:00,ITA,1,Piemonte,45.0732745,7.680687483,311,16,327,3652,3979,336,29043,4172,37194,459191
4781,2020-10-08T17:00:00,ITA,16,Puglia,41.12559576,16.86736689,278,23,301,3033,3334,248,4929,604,8867,312343
4782,2020-10-08T17:00:00,ITA,20,Sardegna,39.21531192,9.110616306,129,19,148,2322,2470,127,1977,161,4608,174362
4783,2020-10-08T17:00:00,ITA,19,Sicilia,38.11569725,13.3623567,376,33,409,3287,3696,259,4454,329,8479,383416
4784,2020-10-08T17:00:00,ITA,9,Toscana,43.76923077,11.25588885,132,27,159,4590,4749,339,10693,1170,16612,541159
4785,2020-10-08T17:00:00,ITA,10,Umbria,43.10675841,12.38824698,50,8,58,805,863,84,1956,87,2906,131965
4786,2020-10-08T17:00:00,ITA,2,Valle d'Aosta,45.73750286,7.320149366,4,1,5,117,122,18,1116,146,1384,21086
4787,2020-10-08T17:00:00,ITA,5,Veneto,45.43490485,12.33845213,213,19,232,4851,5083,491,22620,2206,29909,790836
4788,2020-10-09T17:00:00,ITA,13,Abruzzo,42.35122196,13.39843823,100,7,107,1142,1249,103,3150,487,4886,138835
4789,2020-10-09T17:00:00,ITA,17,Basilicata,40.63947052,15.80514834,35,0,35,413,448,22,514,35,997,79502
4790,2020-10-09T17:00:00,ITA,18,Calabria,38.90597598,16.59440194,42,1,43,595,638,42,1447,103,2188,216285
4791,2020-10-09T17:00:00,ITA,15,Campania,40.83956555,14.25084984,576,63,639,8958,9597,769,7161,475,17233,437971
4792,2020-10-09T17:00:00,ITA,8,Emilia-Romagna,44.49436681,11.3417208,226,14,240,5369,5609,276,26812,4493,36914,709568
4793,2020-10-09T17:00:00,ITA,6,Friuli Venezia Giulia,45.6494354,13.76813649,23,6,29,1112,1141,146,3794,355,5290,195965
4794,2020-10-09T17:00:00,ITA,12,Lazio,41.89277044,12.48366722,853,57,910,8276,9186,387,8983,966,19135,815474
4795,2020-10-09T17:00:00,ITA,7,Liguria,44.41149315,8.9326992,199,26,225,2050,2275,196,10780,1615,14670,181069
4796,2020-10-09T17:00:00,ITA,3,Lombardia,45.46679409,9.190347404,371,44,415,10713,11128,983,82744,16980,110852,1424471
4797,2020-10-09T17:00:00,ITA,11,Marche,43.61675973,13.5188753,37,3,40,1105,1145,49,6262,992,8399,154836
4798,2020-10-09T17:00:00,ITA,14,Molise,41.55774754,14.65916051,8,0,8,144,152,11,524,25,701,45640
4799,2020-10-09T17:00:00,ITA,21,P.A. Bolzano,46.49933453,11.35662422,35,2,37,760,797,85,2799,292,3888,98176
4800,2020-10-09T17:00:00,ITA,22,P.A. Trento,46.06893511,11.12123097,20,0,20,661,681,39,5307,406,6394,104126
4801,2020-10-09T17:00:00,ITA,1,Piemonte,45.0732745,7.680687483,345,22,367,3943,4310,401,29113,4172,37595,462323
4802,2020-10-09T17:00:00,ITA,16,Puglia,41.12559576,16.86736689,300,23,323,3227,3550,249,4960,606,9116,315837
4803,2020-10-09T17:00:00,ITA,20,Sardegna,39.21531192,9.110616306,133,23,156,2413,2569,134,2012,161,4742,176462
4804,2020-10-09T17:00:00,ITA,19,Sicilia,38.11569725,13.3623567,376,35,411,3490,3901,233,4478,333,8712,387714
4805,2020-10-09T17:00:00,ITA,9,Toscana,43.76923077,11.25588885,140,30,170,4951,5121,483,10801,1173,17095,548458
4806,2020-10-09T17:00:00,ITA,10,Umbria,43.10675841,12.38824698,55,8,63,937,1000,151,1970,87,3057,133522
4807,2020-10-09T17:00:00,ITA,2,Valle d'Aosta,45.73750286,7.320149366,4,2,6,133,139,18,1117,146,1402,21200
4808,2020-10-09T17:00:00,ITA,5,Veneto,45.43490485,12.33845213,208,21,229,5245,5474,595,22821,2209,30504,796159
4809,2020-10-10T17:00:00,ITA,13,Abruzzo,42.35122196,13.39843823,110,7,117,1224,1341,94,3152,487,4980,140150
4810,2020-10-10T17:00:00,ITA,17,Basilicata,40.63947052,15.80514834,36,0,36,439,475,37,524,35,1034,80358
4811,2020-10-10T17:00:00,ITA,18,Calabria,38.90597598,16.59440194,41,1,42,654,696,68,1457,103,2256,218830
4812,2020-10-10T17:00:00,ITA,15,Campania,40.83956555,14.25084984,635,63,698,9493,10191,664,7229,477,17897,446216
4813,2020-10-10T17:00:00,ITA,8,Emilia-Romagna,44.49436681,11.3417208,241,16,257,5719,5976,383,26827,4494,37297,715054
4814,2020-10-10T17:00:00,ITA,6,Friuli Venezia Giulia,45.6494354,13.76813649,23,6,29,1215,1244,126,3817,355,5416,197963
4815,2020-10-10T17:00:00,ITA,12,Lazio,41.89277044,12.48366722,884,57,941,8564,9505,384,9042,972,19519,826222
4816,2020-10-10T17:00:00,ITA,7,Liguria,44.41149315,8.9326992,222,26,248,2198,2446,213,10820,1617,14883,183026
4817,2020-10-10T17:00:00,ITA,3,Lombardia,45.46679409,9.190347404,408,44,452,11570,12022,1140,82988,16982,111992,1438722
4818,2020-10-10T17:00:00,ITA,11,Marche,43.61675973,13.5188753,41,3,44,1159,1203,86,6290,992,8485,156147
4819,2020-10-10T17:00:00,ITA,14,Molise,41.55774754,14.65916051,7,0,7,135,142,10,543,26,711,46155
4820,2020-10-10T17:00:00,ITA,21,P.A. Bolzano,46.49933453,11.35662422,35,2,37,836,873,92,2815,292,3980,99125
4821,2020-10-10T17:00:00,ITA,22,P.A. Trento,46.06893511,11.12123097,19,0,19,668,687,50,5349,408,6444,104720
4822,2020-10-10T17:00:00,ITA,1,Piemonte,45.0732745,7.680687483,354,22,376,4365,4741,499,29179,4174,38094,467397
4823,2020-10-10T17:00:00,ITA,16,Puglia,41.12559576,16.86736689,300,22,322,3389,3711,184,4982,607,9300,319289
4824,2020-10-10T17:00:00,ITA,20,Sardegna,39.21531192,9.110616306,140,25,165,2506,2671,124,2034,161,4866,177776
4825,2020-10-10T17:00:00,ITA,19,Sicilia,38.11569725,13.3623567,387,35,422,3721,4143,285,4519,335,8997,392395
4826,2020-10-10T17:00:00,ITA,9,Toscana,43.76923077,11.25588885,160,30,190,5450,5640,548,10830,1173,17643,556336
4827,2020-10-10T17:00:00,ITA,10,Umbria,43.10675841,12.38824698,56,8,64,1046,1110,132,1991,88,3189,134818
4828,2020-10-10T17:00:00,ITA,2,Valle d'Aosta,45.73750286,7.320149366,6,3,9,171,180,44,1120,146,1446,21356
4829,2020-10-10T17:00:00,ITA,5,Veneto,45.43490485,12.33845213,231,20,251,5581,5832,561,23017,2216,31065,801647
4830,2020-10-11T17:00:00,ITA,13,Abruzzo,42.35122196,13.39843823,116,8,124,1293,1417,77,3153,487,5057,141605
4831,2020-10-11T17:00:00,ITA,17,Basilicata,40.63947052,15.80514834,36,0,36,449,485,13,527,35,1047,81320
4832,2020-10-11T17:00:00,ITA,18,Calabria,38.90597598,16.59440194,41,1,42,688,730,35,1458,103,2291,220526
4833,2020-10-11T17:00:00,ITA,15,Campania,40.83956555,14.25084984,664,61,725,9969,10694,633,7357,479,18530,454679
4834,2020-10-11T17:00:00,ITA,8,Emilia-Romagna,44.49436681,11.3417208,254,23,277,6072,6349,384,26837,4495,37681,719690
4835,2020-10-11T17:00:00,ITA,6,Friuli Venezia Giulia,45.6494354,13.76813649,22,5,27,1296,1323,97,3834,356,5513,198763
4836,2020-10-11T17:00:00,ITA,12,Lazio,41.89277044,12.48366722,911,69,980,8862,9842,371,9072,976,19890,836669
4837,2020-10-11T17:00:00,ITA,7,Liguria,44.41149315,8.9326992,238,26,264,2334,2598,386,11052,1619,15269,184673
4838,2020-10-11T17:00:00,ITA,3,Lombardia,45.46679409,9.190347404,433,48,481,12368,12849,1032,83190,16985,113024,1448672
4839,2020-10-11T17:00:00,ITA,11,Marche,43.61675973,13.5188753,44,6,50,1253,1303,108,6298,992,8593,157585
4840,2020-10-11T17:00:00,ITA,14,Molise,41.55774754,14.65916051,9,0,9,156,165,28,548,26,739,46626
4841,2020-10-11T17:00:00,ITA,21,P.A. Bolzano,46.49933453,11.35662422,35,1,36,904,940,84,2831,293,4064,99917
4842,2020-10-11T17:00:00,ITA,22,P.A. Trento,46.06893511,11.12123097,19,0,19,662,681,39,5394,408,6483,105220
4843,2020-10-11T17:00:00,ITA,1,Piemonte,45.0732745,7.680687483,378,24,402,4654,5056,409,29270,4177,38503,472398
4844,2020-10-11T17:00:00,ITA,16,Puglia,41.12559576,16.86736689,301,21,322,3485,3807,212,5097,608,9512,321156
4845,2020-10-11T17:00:00,ITA,20,Sardegna,39.21531192,9.110616306,140,22,162,2610,2772,143,2072,165,5009,179167
4846,2020-10-11T17:00:00,ITA,19,Sicilia,38.11569725,13.3623567,388,38,426,3975,4401,297,4557,336,9294,395172
4847,2020-10-11T17:00:00,ITA,9,Toscana,43.76923077,11.25588885,186,31,217,5925,6142,517,10844,1174,18160,564468
4848,2020-10-11T17:00:00,ITA,10,Umbria,43.10675841,12.38824698,58,9,67,1169,1236,135,2000,88,3324,136523
4849,2020-10-11T17:00:00,ITA,2,Valle d'Aosta,45.73750286,7.320149366,8,3,11,186,197,18,1121,146,1464,21530
4850,2020-10-11T17:00:00,ITA,5,Veneto,45.43490485,12.33845213,238,24,262,5826,6088,438,23197,2218,31503,806051
4851,2020-10-12T17:00:00,ITA,13,Abruzzo,42.35122196,13.39843823,137,11,148,1384,1532,117,3154,488,5174,142974
4852,2020-10-12T17:00:00,ITA,17,Basilicata,40.63947052,15.80514834,36,0,36,459,495,11,528,35,1058,81450
4853,2020-10-12T17:00:00,ITA,18,Calabria,38.90597598,16.59440194,42,1,43,730,773,53,1467,104,2344,221754
4854,2020-10-12T17:00:00,ITA,15,Campania,40.83956555,14.25084984,685,64,749,10477,11226,662,7487,479,19192,460813
4855,2020-10-12T17:00:00,ITA,8,Emilia-Romagna,44.49436681,11.3417208,284,25,309,6364,6673,337,26849,4496,38018,723741
4856,2020-10-12T17:00:00,ITA,6,Friuli Venezia Giulia,45.6494354,13.76813649,22,5,27,1345,1372,59,3844,356,5572,199799
4857,2020-10-12T17:00:00,ITA,12,Lazio,41.89277044,12.48366722,927,78,1005,9117,10122,395,9179,984,20285,849390
4858,2020-10-12T17:00:00,ITA,7,Liguria,44.41149315,8.9326992,261,24,285,2456,2741,186,11093,1621,15455,185406
4859,2020-10-12T17:00:00,ITA,3,Lombardia,45.46679409,9.190347404,463,50,513,12866,13379,696,83353,16988,113720,1458192
4860,2020-10-12T17:00:00,ITA,11,Marche,43.61675973,13.5188753,50,5,55,1274,1329,37,6309,992,8630,158054
4861,2020-10-12T17:00:00,ITA,14,Molise,41.55774754,14.65916051,9,0,9,155,164,7,556,26,746,47043
4862,2020-10-12T17:00:00,ITA,21,P.A. Bolzano,46.49933453,11.35662422,42,2,44,929,973,45,2843,293,4109,100427
4863,2020-10-12T17:00:00,ITA,22,P.A. Trento,46.06893511,11.12123097,19,0,19,661,680,2,5396,409,6485,105284
4864,2020-10-12T17:00:00,ITA,1,Piemonte,45.0732745,7.680687483,457,22,479,4984,5463,454,29314,4180,38957,476939
4865,2020-10-12T17:00:00,ITA,16,Puglia,41.12559576,16.86736689,307,19,326,3587,3913,157,5142,614,9669,323084
4866,2020-10-12T17:00:00,ITA,20,Sardegna,39.21531192,9.110616306,157,23,180,2679,2859,129,2113,166,5138,180487
4867,2020-10-12T17:00:00,ITA,19,Sicilia,38.11569725,13.3623567,404,42,446,4236,4682,298,4571,339,9592,397546
4868,2020-10-12T17:00:00,ITA,9,Toscana,43.76923077,11.25588885,205,40,245,6259,6504,466,10942,1180,18626,570706
4869,2020-10-12T17:00:00,ITA,10,Umbria,43.10675841,12.38824698,61,9,70,1300,1370,148,2012,90,3472,138736
4870,2020-10-12T17:00:00,ITA,2,Valle d'Aosta,45.73750286,7.320149366,9,3,12,213,225,32,1125,146,1496,21680
4871,2020-10-12T17:00:00,ITA,5,Veneto,45.43490485,12.33845213,244,29,273,6016,6289,328,23323,2219,31831,808554
4872,2020-10-13T17:00:00,ITA,13,Abruzzo,42.35122196,13.39843823,146,15,161,1518,1679,146,3153,488,5320,144769
4873,2020-10-13T17:00:00,ITA,17,Basilicata,40.63947052,15.80514834,34,0,34,463,497,8,532,37,1066,82651
4874,2020-10-13T17:00:00,ITA,18,Calabria,38.90597598,16.59440194,42,1,43,755,798,44,1486,104,2388,224137
4875,2020-10-13T17:00:00,ITA,15,Campania,40.83956555,14.25084984,694,62,756,11022,11778,635,7564,485,19827,467964
4876,2020-10-13T17:00:00,ITA,8,Emilia-Romagna,44.49436681,11.3417208,323,31,354,6522,6876,341,26982,4498,38356,728221
4877,2020-10-13T17:00:00,ITA,6,Friuli Venezia Giulia,45.6494354,13.76813649,27,10,37,1367,1404,38,3850,356,5610,200782
4878,2020-10-13T17:00:00,ITA,12,Lazio,41.89277044,12.48366722,896,83,979,9658,10637,579,9238,989,20864,861669
4879,2020-10-13T17:00:00,ITA,7,Liguria,44.41149315,8.9326992,272,27,299,2624,2923,447,11357,1622,15902,188093
4880,2020-10-13T17:00:00,ITA,3,Lombardia,45.46679409,9.190347404,546,62,608,13648,14256,1080,83550,16994,114800,1469625
4881,2020-10-13T17:00:00,ITA,11,Marche,43.61675973,13.5188753,60,6,66,1329,1395,82,6325,992,8712,158948
4882,2020-10-13T17:00:00,ITA,14,Molise,41.55774754,14.65916051,10,0,10,200,210,49,559,26,795,47568
4883,2020-10-13T17:00:00,ITA,21,P.A. Bolzano,46.49933453,11.35662422,54,3,57,937,994,34,2856,293,4143,100855
4884,2020-10-13T17:00:00,ITA,22,P.A. Trento,46.06893511,11.12123097,20,0,20,665,685,28,5417,411,6513,105581
4885,2020-10-13T17:00:00,ITA,1,Piemonte,45.0732745,7.680687483,483,30,513,5452,5965,585,29394,4183,39542,480303
4886,2020-10-13T17:00:00,ITA,16,Puglia,41.12559576,16.86736689,310,23,333,3665,3998,180,5235,616,9849,327324
4887,2020-10-13T17:00:00,ITA,20,Sardegna,39.21531192,9.110616306,164,26,190,2710,2900,157,2227,168,5295,182625
4888,2020-10-13T17:00:00,ITA,19,Sicilia,38.11569725,13.3623567,426,44,470,4407,4877,334,4708,341,9926,402751
4889,2020-10-13T17:00:00,ITA,9,Toscana,43.76923077,11.25588885,218,44,262,6655,6917,480,11008,1181,19106,576101
4890,2020-10-13T17:00:00,ITA,10,Umbria,43.10675841,12.38824698,68,11,79,1412,1491,136,2027,90,3608,140125
4891,2020-10-13T17:00:00,ITA,2,Valle d'Aosta,45.73750286,7.320149366,11,3,14,244,258,33,1125,146,1529,21861
4892,2020-10-13T17:00:00,ITA,5,Veneto,45.43490485,12.33845213,272,33,305,6350,6655,485,23435,2226,32316,810366
4893,2020-10-14T17:00:00,ITA,13,Abruzzo,42.35122196,13.39843823,154,15,169,1632,1801,126,3156,489,5446,146193
4894,2020-10-14T17:00:00,ITA,17,Basilicata,40.63947052,15.80514834,35,0,35,469,504,9,534,37,1075,83619
4895,2020-10-14T17:00:00,ITA,18,Calabria,38.90597598,16.59440194,44,1,45,801,846,60,1498,104,2448,226572
4896,2020-10-14T17:00:00,ITA,15,Campania,40.83956555,14.25084984,735,61,796,11647,12443,818,7715,487,20645,476051
4897,2020-10-14T17:00:00,ITA,8,Emilia-Romagna,44.49436681,11.3417208,383,35,418,6730,7148,339,27045,4502,38695,736069
4898,2020-10-14T17:00:00,ITA,6,Friuli Venezia Giulia,45.6494354,13.76813649,28,11,39,1515,1554,182,3882,356,5792,203239
4899,2020-10-14T17:00:00,ITA,12,Lazio,41.89277044,12.48366722,937,85,1022,10041,11063,543,9350,994,21407,872710
4900,2020-10-14T17:00:00,ITA,7,Liguria,44.41149315,8.9326992,286,29,315,2760,3075,362,11566,1623,16264,190129
4901,2020-10-14T17:00:00,ITA,3,Lombardia,45.46679409,9.190347404,645,64,709,14509,15218,1844,84415,17011,116644,1488016
4902,2020-10-14T17:00:00,ITA,11,Marche,43.61675973,13.5188753,64,8,72,1465,1537,166,6349,992,8878,160725
4903,2020-10-14T17:00:00,ITA,14,Molise,41.55774754,14.65916051,9,0,9,215,224,18,563,26,813,47924
4904,2020-10-14T17:00:00,ITA,21,P.A. Bolzano,46.49933453,11.35662422,54,3,57,1061,1118,124,2856,293,4267,101569
4905,2020-10-14T17:00:00,ITA,22,P.A. Trento,46.06893511,11.12123097,20,0,20,638,658,29,5471,413,6542,106152
4906,2020-10-14T17:00:00,ITA,1,Piemonte,45.0732745,7.680687483,562,33,595,5792,6387,499,29467,4187,40041,482280
4907,2020-10-14T17:00:00,ITA,16,Puglia,41.12559576,16.86736689,311,23,334,3895,4229,315,5317,618,10164,330789
4908,2020-10-14T17:00:00,ITA,20,Sardegna,39.21531192,9.110616306,172,26,198,2728,2926,122,2323,168,5417,184574
4909,2020-10-14T17:00:00,ITA,19,Sicilia,38.11569725,13.3623567,447,49,496,4691,5187,366,4762,343,10292,407145
4910,2020-10-14T17:00:00,ITA,9,Toscana,43.76923077,11.25588885,229,46,275,7152,7427,575,11071,1183,19681,583506
4911,2020-10-14T17:00:00,ITA,10,Umbria,43.10675841,12.38824698,71,12,83,1540,1623,141,2035,91,3749,142109
4912,2020-10-14T17:00:00,ITA,2,Valle d'Aosta,45.73750286,7.320149366,13,3,16,279,295,37,1125,146,1566,21997
4913,2020-10-14T17:00:00,ITA,5,Veneto,45.43490485,12.33845213,271,35,306,6876,7182,657,23565,2226,32973,818552
4914,2020-10-15T17:00:00,ITA,13,Abruzzo,42.35122196,13.39843823,159,10,169,1824,1993,203,3164,491,5648,148088
4915,2020-10-15T17:00:00,ITA,17,Basilicata,40.63947052,15.80514834,36,0,36,503,539,37,536,37,1112,84605
4916,2020-10-15T17:00:00,ITA,18,Calabria,38.90597598,16.59440194,51,3,54,805,859,39,1524,104,2487,228529
4917,2020-10-15T17:00:00,ITA,15,Campania,40.83956555,14.25084984,762,66,828,12416,13244,1127,8032,496,21772,487147
4918,2020-10-15T17:00:00,ITA,8,Emilia-Romagna,44.49436681,11.3417208,392,49,441,7080,7521,453,27124,4503,39148,742503
4919,2020-10-15T17:00:00,ITA,6,Friuli Venezia Giulia,45.6494354,13.76813649,32,11,43,1604,1647,136,3923,358,5928,205301
4920,2020-10-15T17:00:00,ITA,12,Lazio,41.89277044,12.48366722,969,90,1059,10546,11605,594,9395,1001,22001,884989
4921,2020-10-15T17:00:00,ITA,7,Liguria,44.41149315,8.9326992,316,26,342,2771,3113,432,11957,1626,16696,192467
4922,2020-10-15T17:00:00,ITA,3,Lombardia,45.46679409,9.190347404,726,72,798,16252,17050,2067,84624,17037,118711,1508334
4923,2020-10-15T17:00:00,ITA,11,Marche,43.61675973,13.5188753,61,9,70,1594,1664,140,6362,992,9018,162176
4924,2020-10-15T17:00:00,ITA,14,Molise,41.55774754,14.65916051,7,0,7,244,251,30,566,26,843,48828
4925,2020-10-15T17:00:00,ITA,21,P.A. Bolzano,46.49933453,11.35662422,60,3,63,1130,1193,98,2879,293,4365,102467
4926,2020-10-15T17:00:00,ITA,22,P.A. Trento,46.06893511,11.12123097,20,0,20,648,668,62,5521,415,6604,106544
4927,2020-10-15T17:00:00,ITA,1,Piemonte,45.0732745,7.680687483,595,40,635,6673,7308,1033,29576,4190,41074,489887
4928,2020-10-15T17:00:00,ITA,16,Puglia,41.12559576,16.86736689,319,26,345,4064,4409,257,5387,625,10421,334382
4929,2020-10-15T17:00:00,ITA,20,Sardegna,39.21531192,9.110616306,180,28,208,2816,3024,186,2410,169,5603,186956
4930,2020-10-15T17:00:00,ITA,19,Sicilia,38.11569725,13.3623567,468,52,520,4967,5487,399,4854,350,10691,411784
4931,2020-10-15T17:00:00,ITA,9,Toscana,43.76923077,11.25588885,276,46,322,7584,7906,581,11171,1185,20262,591385
4932,2020-10-15T17:00:00,ITA,10,Umbria,43.10675841,12.38824698,74,12,86,1731,1817,263,2104,91,4012,144075
4933,2020-10-15T17:00:00,ITA,2,Valle d'Aosta,45.73750286,7.320149366,14,3,17,343,360,67,1127,146,1633,22227
4934,2020-10-15T17:00:00,ITA,5,Veneto,45.43490485,12.33845213,279,40,319,7289,7608,600,23728,2237,33573,825788
4935,2020-10-16T17:00:00,ITA,13,Abruzzo,42.35122196,13.39843823,167,11,178,1972,2150,178,3184,491,5825,150236
4936,2020-10-16T17:00:00,ITA,17,Basilicata,40.63947052,15.80514834,36,0,36,547,583,57,548,38,1169,85721
4937,2020-10-16T17:00:00,ITA,18,Calabria,38.90597598,16.59440194,51,4,55,849,904,102,1581,104,2589,231287
4938,2020-10-16T17:00:00,ITA,15,Campania,40.83956555,14.25084984,786,67,853,13501,14354,1261,8180,499,23033,498492
4939,2020-10-16T17:00:00,ITA,8,Emilia-Romagna,44.49436681,11.3417208,404,61,465,7568,8033,544,27155,4504,39692,748337
4940,2020-10-16T17:00:00,ITA,6,Friuli Venezia Giulia,45.6494354,13.76813649,45,12,57,1742,1799,165,3935,359,6093,206998
4941,2020-10-16T17:00:00,ITA,12,Lazio,41.89277044,12.48366722,1004,98,1102,11215,12317,795,9473,1006,22796,901184
4942,2020-10-16T17:00:00,ITA,7,Liguria,44.41149315,8.9326992,347,32,379,2862,3241,585,12408,1632,17281,194933
4943,2020-10-16T17:00:00,ITA,3,Lombardia,45.46679409,9.190347404,834,71,905,18223,19128,2419,84958,17044,121130,1527182
4944,2020-10-16T17:00:00,ITA,11,Marche,43.61675973,13.5188753,73,10,83,1671,1754,115,6387,992,9133,163367
4945,2020-10-16T17:00:00,ITA,14,Molise,41.55774754,14.65916051,8,0,8,257,265,21,573,26,864,49359
4946,2020-10-16T17:00:00,ITA,21,P.A. Bolzano,46.49933453,11.35662422,66,6,72,1231,1303,128,2897,293,4493,103548
4947,2020-10-16T17:00:00,ITA,22,P.A. Trento,46.06893511,11.12123097,20,0,20,705,725,111,5574,416,6715,107156
4948,2020-10-16T17:00:00,ITA,1,Piemonte,45.0732745,7.680687483,658,43,701,7357,8058,821,29643,4194,41895,493847
4949,2020-10-16T17:00:00,ITA,16,Puglia,41.12559576,16.86736689,326,26,352,4321,4673,313,5431,630,10734,338385
4950,2020-10-16T17:00:00,ITA,20,Sardegna,39.21531192,9.110616306,187,29,216,2879,3095,133,2470,171,5736,189006
4951,2020-10-16T17:00:00,ITA,19,Sicilia,38.11569725,13.3623567,471,58,529,5405,5934,578,4975,360,11269,416980
4952,2020-10-16T17:00:00,ITA,9,Toscana,43.76923077,11.25588885,308,51,359,8156,8515,755,11315,1187,21017,598910
4953,2020-10-16T17:00:00,ITA,10,Umbria,43.10675841,12.38824698,75,15,90,1871,1961,198,2158,91,4210,145535
4954,2020-10-16T17:00:00,ITA,2,Valle d'Aosta,45.73750286,7.320149366,13,4,17,365,382,27,1132,146,1660,22334
4955,2020-10-16T17:00:00,ITA,5,Veneto,45.43490485,12.33845213,299,40,339,7799,8138,704,23895,2244,34277,828067
4956,2020-10-17T17:00:00,ITA,13,Abruzzo,42.35122196,13.39843823,169,13,182,2112,2294,148,3186,493,5973,151830
4957,2020-10-17T17:00:00,ITA,17,Basilicata,40.63947052,15.80514834,40,0,40,598,638,57,550,38,1226,86834
4958,2020-10-17T17:00:00,ITA,18,Calabria,38.90597598,16.59440194,58,5,63,931,994,94,1585,104,2683,234284
4959,2020-10-17T17:00:00,ITA,15,Campania,40.83956555,14.25084984,817,75,892,14798,15690,1410,8254,499,24443,509918
4960,2020-10-17T17:00:00,ITA,8,Emilia-Romagna,44.49436681,11.3417208,427,65,492,8157,8649,641,27175,4509,40333,754101
4961,2020-10-17T17:00:00,ITA,6,Friuli Venezia Giulia,45.6494354,13.76813649,49,13,62,1877,1939,167,3962,359,6260,208471
4962,2020-10-17T17:00:00,ITA,12,Lazio,41.89277044,12.48366722,1043,98,1141,12096,13237,994,9535,1018,23790,924313
4963,2020-10-17T17:00:00,ITA,7,Liguria,44.41149315,8.9326992,364,38,402,3156,3558,464,12554,1633,17745,197088
4964,2020-10-17T17:00:00,ITA,3,Lombardia,45.46679409,9.190347404,943,96,1039,20586,21625,2664,85112,17057,123794,1544959
4965,2020-10-17T17:00:00,ITA,11,Marche,43.61675973,13.5188753,77,10,87,1775,1862,121,6400,992,9254,164588
4966,2020-10-17T17:00:00,ITA,14,Molise,41.55774754,14.65916051,9,0,9,321,330,65,573,26,929,50306
4967,2020-10-17T17:00:00,ITA,21,P.A. Bolzano,46.49933453,11.35662422,66,6,72,1372,1444,155,2911,293,4648,104499
4968,2020-10-17T17:00:00,ITA,22,P.A. Trento,46.06893511,11.12123097,27,0,27,744,771,82,5609,417,6797,107750
4969,2020-10-17T17:00:00,ITA,1,Piemonte,45.0732745,7.680687483,701,51,752,8128,8880,972,29791,4196,42867,498420
4970,2020-10-17T17:00:00,ITA,16,Puglia,41.12559576,16.86736689,368,33,401,4579,4980,350,5472,632,11084,342024
4971,2020-10-17T17:00:00,ITA,20,Sardegna,39.21531192,9.110616306,192,30,222,2966,3188,130,2506,172,5866,191734
4972,2020-10-17T17:00:00,ITA,19,Sicilia,38.11569725,13.3623567,479,61,540,5741,6281,475,5101,362,11744,422068
4973,2020-10-17T17:00:00,ITA,9,Toscana,43.76923077,11.25588885,344,50,394,8853,9247,879,11460,1189,21896,608130
4974,2020-10-17T17:00:00,ITA,10,Umbria,43.10675841,12.38824698,99,16,115,2015,2130,205,2193,92,4415,147587
4975,2020-10-17T17:00:00,ITA,2,Valle d'Aosta,45.73750286,7.320149366,17,2,19,439,458,78,1134,146,1738,22585
4976,2020-10-17T17:00:00,ITA,5,Veneto,45.43490485,12.33845213,328,43,371,8369,8740,774,24064,2247,35051,832701
4977,2020-10-18T17:00:00,ITA,13,Abruzzo,42.35122196,13.39843823,170,13,183,2330,2513,221,3187,494,6194,153850
4978,2020-10-18T17:00:00,ITA,17,Basilicata,40.63947052,15.80514834,43,0,43,637,680,48,555,39,1274,87784
4979,2020-10-18T17:00:00,ITA,18,Calabria,38.90597598,16.59440194,61,5,66,1006,1072,78,1585,104,2761,236641
4980,2020-10-18T17:00:00,ITA,15,Campania,40.83956555,14.25084984,849,78,927,15938,16865,1376,8453,501,25819,519783
4981,2020-10-18T17:00:00,ITA,8,Emilia-Romagna,44.49436681,11.3417208,439,67,506,8657,9163,526,27181,4515,40859,760075
4982,2020-10-18T17:00:00,ITA,6,Friuli Venezia Giulia,45.6494354,13.76813649,56,14,70,2011,2081,155,3973,361,6415,209531
4983,2020-10-18T17:00:00,ITA,12,Lazio,41.89277044,12.48366722,1085,99,1184,13196,14380,1198,9584,1024,24988,941774
4984,2020-10-18T17:00:00,ITA,7,Liguria,44.41149315,8.9326992,402,39,441,3318,3759,370,12720,1636,18115,198617
4985,2020-10-18T17:00:00,ITA,3,Lombardia,45.46679409,9.190347404,1065,110,1175,22119,23294,2975,86397,17078,126769,1565233
4986,2020-10-18T17:00:00,ITA,11,Marche,43.61675973,13.5188753,88,13,101,1944,2045,204,6418,995,9458,166250
4987,2020-10-18T17:00:00,ITA,14,Molise,41.55774754,14.65916051,12,0,12,343,355,27,575,26,956,51313
4988,2020-10-18T17:00:00,ITA,21,P.A. Bolzano,46.49933453,11.35662422,67,7,74,1533,1607,171,2919,293,4819,105500
4989,2020-10-18T17:00:00,ITA,22,P.A. Trento,46.06893511,11.12123097,38,0,38,763,801,48,5627,417,6845,108040
4990,2020-10-18T17:00:00,ITA,1,Piemonte,45.0732745,7.680687483,780,55,835,8998,9833,1123,29959,4198,43990,505300
4991,2020-10-18T17:00:00,ITA,16,Puglia,41.12559576,16.86736689,377,36,413,4820,5233,301,5517,635,11385,344122
4992,2020-10-18T17:00:00,ITA,20,Sardegna,39.21531192,9.110616306,208,29,237,3159,3396,230,2526,174,6096,193627
4993,2020-10-18T17:00:00,ITA,19,Sicilia,38.11569725,13.3623567,493,70,563,6227,6790,548,5137,365,12292,426503
4994,2020-10-18T17:00:00,ITA,9,Toscana,43.76923077,11.25588885,385,55,440,9546,9986,906,11622,1194,22802,617111
4995,2020-10-18T17:00:00,ITA,10,Umbria,43.10675841,12.38824698,115,14,129,2302,2431,327,2219,92,4742,149410
4996,2020-10-18T17:00:00,ITA,2,Valle d'Aosta,45.73750286,7.320149366,20,2,22,506,528,73,1137,146,1811,22840
4997,2020-10-18T17:00:00,ITA,5,Veneto,45.43490485,12.33845213,378,44,422,9003,9425,800,24170,2256,35851,836440
4998,2020-10-19T17:00:00,ITA,13,Abruzzo,42.35122196,13.39843823,197,13,210,2459,2669,159,3190,494,6353,155193
4999,2020-10-19T17:00:00,ITA,17,Basilicata,40.63947052,15.80514834,51,1,52,646,698,22,559,39,1296,88191
5000,2020-10-19T17:00:00,ITA,18,Calabria,38.90597598,16.59440194,66,5,71,1099,1170,108,1595,104,2869,238117
5001,2020-10-19T17:00:00,ITA,15,Campania,40.83956555,14.25084984,884,85,969,17345,18314,1593,8576,522,27412,529648
5002,2020-10-19T17:00:00,ITA,8,Emilia-Romagna,44.49436681,11.3417208,481,70,551,9119,9670,552,27222,4518,41410,763923
5003,2020-10-19T17:00:00,ITA,6,Friuli Venezia Giulia,45.6494354,13.76813649,62,13,75,2093,2168,90,3973,364,6505,210178
5004,2020-10-19T17:00:00,ITA,12,Lazio,41.89277044,12.48366722,1130,111,1241,13950,15191,939,9703,1033,25927,954419
5005,2020-10-19T17:00:00,ITA,7,Liguria,44.41149315,8.9326992,436,34,470,3441,3911,323,12886,1641,18438,199539
5006,2020-10-19T17:00:00,ITA,3,Lombardia,45.46679409,9.190347404,1136,113,1249,23385,24634,1687,86738,17084,128456,1575120
5007,2020-10-19T17:00:00,ITA,11,Marche,43.61675973,13.5188753,97,16,113,2005,2118,98,6443,995,9556,166944
5008,2020-10-19T17:00:00,ITA,14,Molise,41.55774754,14.65916051,12,0,12,381,393,38,575,26,994,52049
5009,2020-10-19T17:00:00,ITA,21,P.A. Bolzano,46.49933453,11.35662422,67,7,74,1616,1690,85,2920,294,4904,106284
5010,2020-10-19T17:00:00,ITA,22,P.A. Trento,46.06893511,11.12123097,44,0,44,819,863,79,5643,418,6924,108329
5011,2020-10-19T17:00:00,ITA,1,Piemonte,45.0732745,7.680687483,883,61,944,9663,10607,933,30113,4203,44923,511428
5012,2020-10-19T17:00:00,ITA,16,Puglia,41.12559576,16.86736689,397,38,435,5028,5463,321,5604,639,11706,346220
5013,2020-10-19T17:00:00,ITA,20,Sardegna,39.21531192,9.110616306,210,33,243,3259,3502,159,2579,174,6255,195681
5014,2020-10-19T17:00:00,ITA,19,Sicilia,38.11569725,13.3623567,521,72,593,6426,7019,362,5267,368,12654,428508
5015,2020-10-19T17:00:00,ITA,9,Toscana,43.76923077,11.25588885,449,62,511,10340,10851,986,11731,1206,23788,624289
5016,2020-10-19T17:00:00,ITA,10,Umbria,43.10675841,12.38824698,131,15,146,2423,2569,167,2247,93,4909,150026
5017,2020-10-19T17:00:00,ITA,2,Valle d'Aosta,45.73750286,7.320149366,26,4,30,628,658,135,1142,146,1946,23091
5018,2020-10-19T17:00:00,ITA,5,Veneto,45.43490485,12.33845213,396,44,440,9405,9845,502,24253,2255,36353,838391
5019,2020-10-20T17:00:00,ITA,13,Abruzzo,42.35122196,13.39843823,210,15,225,2620,2845,184,3194,495,6534,156991
5020,2020-10-20T17:00:00,ITA,17,Basilicata,40.63947052,15.80514834,51,1,52,661,713,17,561,39,1313,89296
5021,2020-10-20T17:00:00,ITA,18,Calabria,38.90597598,16.59440194,73,6,79,1173,1252,94,1607,104,2963,240594
5022,2020-10-20T17:00:00,ITA,15,Campania,40.83956555,14.25084984,946,91,1037,18421,19458,1312,8732,534,28724,538297
5023,2020-10-20T17:00:00,ITA,8,Emilia-Romagna,44.49436681,11.3417208,531,78,609,9559,10168,507,27226,4523,41917,769327
5024,2020-10-20T17:00:00,ITA,6,Friuli Venezia Giulia,45.6494354,13.76813649,65,14,79,1853,1932,131,4338,366,6636,211397
5025,2020-10-20T17:00:00,ITA,12,Lazio,41.89277044,12.48366722,1196,123,1319,15014,16333,1224,9780,1038,27151,969373
5026,2020-10-20T17:00:00,ITA,7,Liguria,44.41149315,8.9326992,505,32,537,3947,4484,907,13214,1647,19345,202738
5027,2020-10-20T17:00:00,ITA,3,Lombardia,45.46679409,9.190347404,1268,123,1391,24913,26304,2023,87072,17103,130479,1588800
5028,2020-10-20T17:00:00,ITA,11,Marche,43.61675973,13.5188753,99,19,118,2064,2182,89,6467,996,9645,167857
5029,2020-10-20T17:00:00,ITA,14,Molise,41.55774754,14.65916051,12,0,12,401,413,26,581,26,1020,52527
5030,2020-10-20T17:00:00,ITA,21,P.A. Bolzano,46.49933453,11.35662422,96,7,103,1791,1894,209,2924,295,5113,107299
5031,2020-10-20T17:00:00,ITA,22,P.A. Trento,46.06893511,11.12123097,45,1,46,718,764,94,5836,418,7018,108619
5032,2020-10-20T17:00:00,ITA,1,Piemonte,45.0732745,7.680687483,1037,62,1099,10783,11882,1396,30228,4209,46319,519289
5033,2020-10-20T17:00:00,ITA,16,Puglia,41.12559576,16.86736689,432,39,471,5259,5730,295,5629,642,12001,350691
5034,2020-10-20T17:00:00,ITA,20,Sardegna,39.21531192,9.110616306,226,34,260,3426,3686,221,2613,177,6476,197486
5035,2020-10-20T17:00:00,ITA,19,Sicilia,38.11569725,13.3623567,542,77,619,6878,7497,574,5353,378,13228,434040
5036,2020-10-20T17:00:00,ITA,9,Toscana,43.76923077,11.25588885,475,72,547,10999,11546,812,11846,1208,24600,631648
5037,2020-10-20T17:00:00,ITA,10,Umbria,43.10675841,12.38824698,150,20,170,2505,2675,194,2335,93,5103,152168
5038,2020-10-20T17:00:00,ITA,2,Valle d'Aosta,45.73750286,7.320149366,36,5,41,684,725,75,1150,146,2021,23263
5039,2020-10-20T17:00:00,ITA,5,Veneto,45.43490485,12.33845213,459,51,510,9746,10256,490,24319,2268,36843,841548
5040,2020-10-21T17:00:00,ITA,13,Abruzzo,42.35122196,13.39843823,212,14,226,2865,3091,252,3195,500,6786,158874
5041,2020-10-21T17:00:00,ITA,17,Basilicata,40.63947052,15.80514834,48,4,52,723,775,85,584,39,1398,90497
5042,2020-10-21T17:00:00,ITA,18,Calabria,38.90597598,16.59440194,81,6,87,1293,1380,136,1614,105,3099,243043
5043,2020-10-21T17:00:00,ITA,15,Campania,40.83956555,14.25084984,996,85,1081,20020,21101,1760,8838,545,30484,548083
5044,2020-10-21T17:00:00,ITA,8,Emilia-Romagna,44.49436681,11.3417208,596,86,682,10118,10800,671,27257,4531,42588,777142
5045,2020-10-21T17:00:00,ITA,6,Friuli Venezia Giulia,45.6494354,13.76813649,76,16,92,2014,2106,219,4382,367,6855,212729
5046,2020-10-21T17:00:00,ITA,12,Lazio,41.89277044,12.48366722,1226,129,1355,16048,17403,1219,9913,1054,28370,984926
5047,2020-10-21T17:00:00,ITA,7,Liguria,44.41149315,8.9326992,547,31,578,4043,4621,546,13614,1656,19891,204834
5048,2020-10-21T17:00:00,ITA,3,Lombardia,45.46679409,9.190347404,1521,134,1655,28235,29890,4125,87591,17123,134604,1611623
5049,2020-10-21T17:00:00,ITA,11,Marche,43.61675973,13.5188753,115,19,134,2243,2377,226,6497,997,9871,169343
5050,2020-10-21T17:00:00,ITA,14,Molise,41.55774754,14.65916051,9,1,10,415,425,22,591,26,1042,53291
5051,2020-10-21T17:00:00,ITA,21,P.A. Bolzano,46.49933453,11.35662422,96,7,103,1977,2080,189,2926,296,5302,108212
5052,2020-10-21T17:00:00,ITA,22,P.A. Trento,46.06893511,11.12123097,48,2,50,798,848,148,5898,420,7166,109666
5053,2020-10-21T17:00:00,ITA,1,Piemonte,45.0732745,7.680687483,1111,74,1185,12250,13435,1799,30467,4216,48118,529281
5054,2020-10-21T17:00:00,ITA,16,Puglia,41.12559576,16.86736689,438,42,480,5511,5991,324,5690,644,12325,355311
5055,2020-10-21T17:00:00,ITA,20,Sardegna,39.21531192,9.110616306,236,36,272,3539,3811,167,2652,180,6643,199392
5056,2020-10-21T17:00:00,ITA,19,Sicilia,38.11569725,13.3623567,565,83,648,7202,7850,562,5551,389,13790,437540
5057,2020-10-21T17:00:00,ITA,9,Toscana,43.76923077,11.25588885,503,76,579,11660,12239,866,12006,1221,25466,639007
5058,2020-10-21T17:00:00,ITA,10,Umbria,43.10675841,12.38824698,152,20,172,2783,2955,350,2403,95,5453,154074
5059,2020-10-21T17:00:00,ITA,2,Valle d'Aosta,45.73750286,7.320149366,42,5,47,784,831,111,1155,146,2132,23483
5060,2020-10-21T17:00:00,ITA,5,Veneto,45.43490485,12.33845213,439,56,495,10938,11433,1422,24550,2282,38265,849385
5061,2020-10-22T17:00:00,ITA,13,Abruzzo,42.35122196,13.39843823,208,16,224,3152,3376,306,3214,501,7091,160689
5062,2020-10-22T17:00:00,ITA,17,Basilicata,40.63947052,15.80514834,48,4,52,776,828,83,611,42,1481,91753
5063,2020-10-22T17:00:00,ITA,18,Calabria,38.90597598,16.59440194,86,8,94,1443,1537,187,1644,105,3286,246034
5064,2020-10-22T17:00:00,ITA,15,Campania,40.83956555,14.25084984,1037,94,1131,21430,22561,1541,8913,551,32025,558506
5065,2020-10-22T17:00:00,ITA,8,Emilia-Romagna,44.49436681,11.3417208,636,86,722,10941,11663,889,27277,4537,43477,783681
5066,2020-10-22T17:00:00,ITA,6,Friuli Venezia Giulia,45.6494354,13.76813649,83,14,97,2128,2225,220,4482,368,7075,214444
5067,2020-10-22T17:00:00,ITA,12,Lazio,41.89277044,12.48366722,1293,131,1424,17107,18531,1251,10020,1070,29621,1002866
5068,2020-10-22T17:00:00,ITA,7,Liguria,44.41149315,8.9326992,540,34,574,4492,5066,690,13842,1673,20581,207034
5069,2020-10-22T17:00:00,ITA,3,Lombardia,45.46679409,9.190347404,1685,156,1841,31677,33518,4125,88059,17152,138729,1633109
5070,2020-10-22T17:00:00,ITA,11,Marche,43.61675973,13.5188753,133,19,152,2472,2624,321,6570,998,10192,171050
5071,2020-10-22T17:00:00,ITA,14,Molise,41.55774754,14.65916051,13,1,14,436,450,28,594,26,1070,53975
5072,2020-10-22T17:00:00,ITA,21,P.A. Bolzano,46.49933453,11.35662422,106,8,114,2204,2318,247,2935,296,5549,109343
5073,2020-10-22T17:00:00,ITA,22,P.A. Trento,46.06893511,11.12123097,57,1,58,911,969,153,5927,423,7319,109669
5074,2020-10-22T17:00:00,ITA,1,Piemonte,45.0732745,7.680687483,1226,79,1305,13475,14780,1550,30661,4227,49668,537462
5075,2020-10-22T17:00:00,ITA,16,Puglia,41.12559576,16.86736689,448,50,498,5781,6279,485,5886,645,12810,359262
5076,2020-10-22T17:00:00,ITA,20,Sardegna,39.21531192,9.110616306,264,36,300,3693,3993,243,2712,181,6886,202306
5077,2020-10-22T17:00:00,ITA,19,Sicilia,38.11569725,13.3623567,588,89,677,7863,8540,796,5649,397,14586,442472
5078,2020-10-22T17:00:00,ITA,9,Toscana,43.76923077,11.25588885,524,82,606,12655,13261,1145,12121,1229,26611,646277
5079,2020-10-22T17:00:00,ITA,10,Umbria,43.10675841,12.38824698,171,22,193,3077,3270,407,2493,97,5860,156285
5080,2020-10-22T17:00:00,ITA,2,Valle d'Aosta,45.73750286,7.320149366,48,3,51,854,905,87,1165,149,2219,23688
5081,2020-10-22T17:00:00,ITA,5,Veneto,45.43490485,12.33845213,500,59,559,12049,12608,1325,24681,2301,39590,854703
5082,2020-10-23T17:00:00,ITA,13,Abruzzo,42.35122196,13.39843823,228,16,244,3285,3529,234,3293,503,7325,162471
5083,2020-10-23T17:00:00,ITA,17,Basilicata,40.63947052,15.80514834,54,4,58,849,907,89,621,42,1570,93187
5084,2020-10-23T17:00:00,ITA,18,Calabria,38.90597598,16.59440194,100,9,109,1586,1695,159,1645,105,3445,249135
5085,2020-10-23T17:00:00,ITA,15,Campania,40.83956555,14.25084984,1090,98,1188,23447,24635,2280,9107,563,34305,571147
5086,2020-10-23T17:00:00,ITA,8,Emilia-Romagna,44.49436681,11.3417208,657,86,743,11771,12514,888,27304,4547,44365,790989
5087,2020-10-23T17:00:00,ITA,6,Friuli Venezia Giulia,45.6494354,13.76813649,88,19,107,2370,2477,340,4569,369,7415,216003
5088,2020-10-23T17:00:00,ITA,12,Lazio,41.89277044,12.48366722,1354,135,1489,18332,19821,1389,10108,1081,31010,1021323
5089,2020-10-23T17:00:00,ITA,7,Liguria,44.41149315,8.9326992,598,33,631,4838,5469,778,14210,1680,21359,209220
5090,2020-10-23T17:00:00,ITA,3,Lombardia,45.46679409,9.190347404,2013,184,2197,35753,37950,4916,88536,17159,143645,1655276
5091,2020-10-23T17:00:00,ITA,11,Marche,43.61675973,13.5188753,152,22,174,2875,3049,453,6596,1000,10645,173274
5092,2020-10-23T17:00:00,ITA,14,Molise,41.55774754,14.65916051,13,1,14,480,494,56,606,26,1126,54552
5093,2020-10-23T17:00:00,ITA,21,P.A. Bolzano,46.49933453,11.35662422,106,8,114,2468,2582,269,2940,296,5818,110930
5094,2020-10-23T17:00:00,ITA,22,P.A. Trento,46.06893511,11.12123097,65,3,68,1061,1129,207,5974,423,7526,110387
5095,2020-10-23T17:00:00,ITA,1,Piemonte,45.0732745,7.680687483,1362,84,1446,15016,16462,2032,31002,4236,51700,547164
5096,2020-10-23T17:00:00,ITA,16,Puglia,41.12559576,16.86736689,479,52,531,6297,6828,590,5926,646,13400,364270
5097,2020-10-23T17:00:00,ITA,20,Sardegna,39.21531192,9.110616306,275,36,311,3975,4286,349,2768,181,7235,205575
5098,2020-10-23T17:00:00,ITA,19,Sicilia,38.11569725,13.3623567,593,89,682,8454,9136,730,5772,408,15316,447704
5099,2020-10-23T17:00:00,ITA,9,Toscana,43.76923077,11.25588885,574,82,656,13718,14374,1290,12290,1237,27901,653719
5100,2020-10-23T17:00:00,ITA,10,Umbria,43.10675841,12.38824698,183,21,204,3426,3630,447,2577,100,6307,158186
5101,2020-10-23T17:00:00,ITA,2,Valle d'Aosta,45.73750286,7.320149366,50,3,53,948,1001,97,1166,149,2316,23862
5102,2020-10-23T17:00:00,ITA,5,Veneto,45.43490485,12.33845213,515,64,579,13455,14034,1550,24798,2308,41140,860733
5103,2020-10-24T17:00:00,ITA,13,Abruzzo,42.35122196,13.39843823,228,18,246,3496,3742,375,3455,503,7700,164810
5104,2020-10-24T17:00:00,ITA,17,Basilicata,40.63947052,15.80514834,53,5,58,887,945,50,630,44,1619,94401
5105,2020-10-24T17:00:00,ITA,18,Calabria,38.90597598,16.59440194,100,10,110,1739,1849,166,1657,105,3611,252469
5106,2020-10-24T17:00:00,ITA,15,Campania,40.83956555,14.25084984,1118,108,1226,25077,26303,1718,9149,571,36023,579568
5107,2020-10-24T17:00:00,ITA,8,Emilia-Romagna,44.49436681,11.3417208,723,89,812,12830,13642,1180,27343,4557,45542,799074
5108,2020-10-24T17:00:00,ITA,6,Friuli Venezia Giulia,45.6494354,13.76813649,100,16,116,2660,2776,412,4679,372,7827,218014
5109,2020-10-24T17:00:00,ITA,12,Lazio,41.89277044,12.48366722,1438,141,1579,19826,21405,1687,10202,1090,32697,1041123
5110,2020-10-24T17:00:00,ITA,7,Liguria,44.41149315,8.9326992,641,38,679,5081,5760,1035,14948,1686,22394,212171
5111,2020-10-24T17:00:00,ITA,3,Lombardia,45.46679409,9.190347404,2153,213,2366,40319,42685,4956,88706,17210,148601,1675053
5112,2020-10-24T17:00:00,ITA,11,Marche,43.61675973,13.5188753,178,23,201,3098,3299,274,6619,1001,10919,174895
5113,2020-10-24T17:00:00,ITA,14,Molise,41.55774754,14.65916051,16,2,18,507,525,66,640,27,1192,55250
5114,2020-10-24T17:00:00,ITA,21,P.A. Bolzano,46.49933453,11.35662422,133,12,145,2711,2856,277,2943,296,6095,112056
5115,2020-10-24T17:00:00,ITA,22,P.A. Trento,46.06893511,11.12123097,59,4,63,1193,1256,162,6008,424,7688,110914
5116,2020-10-24T17:00:00,ITA,1,Piemonte,45.0732745,7.680687483,1483,88,1571,16272,17843,1548,31157,4248,53248,556121
5117,2020-10-24T17:00:00,ITA,16,Puglia,41.12559576,16.86736689,522,53,575,6823,7398,631,5977,656,14031,367410
5118,2020-10-24T17:00:00,ITA,20,Sardegna,39.21531192,9.110616306,287,36,323,4263,4586,329,2794,184,7564,208859
5119,2020-10-24T17:00:00,ITA,19,Sicilia,38.11569725,13.3623567,606,90,696,9193,9889,886,5896,417,16202,452738
5120,2020-10-24T17:00:00,ITA,9,Toscana,43.76923077,11.25588885,640,87,727,14961,15688,1526,12491,1248,29427,662605
5121,2020-10-24T17:00:00,ITA,10,Umbria,43.10675841,12.38824698,203,25,228,3793,4021,525,2709,102,6832,160255
5122,2020-10-24T17:00:00,ITA,2,Valle d'Aosta,45.73750286,7.320149366,58,2,60,1033,1093,112,1183,152,2428,24087
5123,2020-10-24T17:00:00,ITA,5,Veneto,45.43490485,12.33845213,548,68,616,15005,15621,1729,24931,2317,42869,866907
5124,2020-10-25T17:00:00,ITA,13,Abruzzo,42.35122196,13.39843823,245,18,263,3822,4085,368,3469,514,8068,166730
5125,2020-10-25T17:00:00,ITA,17,Basilicata,40.63947052,15.80514834,53,5,58,955,1013,77,639,44,1696,95573
5126,2020-10-25T17:00:00,ITA,18,Calabria,38.90597598,16.59440194,106,10,116,1897,2013,179,1671,106,3790,255683
5127,2020-10-25T17:00:00,ITA,15,Campania,40.83956555,14.25084984,1151,113,1264,27456,28720,2590,9322,571,38613,587003
5128,2020-10-25T17:00:00,ITA,8,Emilia-Romagna,44.49436681,11.3417208,757,88,845,13983,14828,1192,27345,4561,46734,804679
5129,2020-10-25T17:00:00,ITA,6,Friuli Venezia Giulia,45.6494354,13.76813649,112,23,135,2892,3027,334,4760,374,8161,219485
5130,2020-10-25T17:00:00,ITA,12,Lazio,41.89277044,12.48366722,1476,146,1622,21193,22815,1541,10323,1100,34238,1057293
5131,2020-10-25T17:00:00,ITA,7,Liguria,44.41149315,8.9326992,696,41,737,5299,6036,657,15324,1691,23051,214109
5132,2020-10-25T17:00:00,ITA,3,Lombardia,45.46679409,9.190347404,2326,231,2557,45426,47983,5762,89145,17235,154363,1698094
5133,2020-10-25T17:00:00,ITA,11,Marche,43.61675973,13.5188753,178,23,201,3525,3726,521,6711,1003,11440,177287
5134,2020-10-25T17:00:00,ITA,14,Molise,41.55774754,14.65916051,20,2,22,528,550,26,640,28,1218,55751
5135,2020-10-25T17:00:00,ITA,21,P.A. Bolzano,46.49933453,11.35662422,147,11,158,3029,3187,339,2951,296,6434,113387
5136,2020-10-25T17:00:00,ITA,22,P.A. Trento,46.06893511,11.12123097,72,4,76,1256,1332,104,6035,425,7792,111246
5137,2020-10-25T17:00:00,ITA,1,Piemonte,45.0732745,7.680687483,1601,94,1695,18182,19877,2287,31399,4259,55535,566796
5138,2020-10-25T17:00:00,ITA,16,Puglia,41.12559576,16.86736689,548,57,605,7267,7872,515,6011,663,14546,370561
5139,2020-10-25T17:00:00,ITA,20,Sardegna,39.21531192,9.110616306,299,34,333,4421,4754,195,2814,191,7759,211113
5140,2020-10-25T17:00:00,ITA,19,Sicilia,38.11569725,13.3623567,642,95,737,9818,10555,695,5914,428,16897,456572
5141,2020-10-25T17:00:00,ITA,9,Toscana,43.76923077,11.25588885,714,111,825,16495,17320,1863,12708,1262,31290,671386
5142,2020-10-25T17:00:00,ITA,10,Umbria,43.10675841,12.38824698,215,29,244,4151,4395,463,2795,105,7295,162084
5143,2020-10-25T17:00:00,ITA,2,Valle d'Aosta,45.73750286,7.320149366,63,2,65,1116,1181,97,1191,153,2525,24256
5144,2020-10-25T17:00:00,ITA,5,Veneto,45.43490485,12.33845213,585,71,656,16316,16972,1468,25036,2329,44337,871568
5145,2020-10-26T17:00:00,ITA,13,Abruzzo,42.35122196,13.39843823,249,21,270,4083,4353,348,3537,524,8414,168842
5146,2020-10-26T17:00:00,ITA,17,Basilicata,40.63947052,15.80514834,66,6,72,937,1009,8,651,44,1704,95707
5147,2020-10-26T17:00:00,ITA,18,Calabria,38.90597598,16.59440194,108,9,117,2067,2184,180,1678,108,3970,258151
5148,2020-10-26T17:00:00,ITA,15,Campania,40.83956555,14.25084984,1191,123,1314,29361,30675,1981,9332,587,40594,594439
5149,2020-10-26T17:00:00,ITA,8,Emilia-Romagna,44.49436681,11.3417208,816,93,909,14860,15769,1146,27544,4564,47877,811249
5150,2020-10-26T17:00:00,ITA,6,Friuli Venezia Giulia,45.6494354,13.76813649,119,27,146,3139,3285,334,4833,377,8495,220578
5151,2020-10-26T17:00:00,ITA,12,Lazio,41.89277044,12.48366722,1599,158,1757,22649,24406,1698,10414,1116,35936,1071581
5152,2020-10-26T17:00:00,ITA,7,Liguria,44.41149315,8.9326992,788,46,834,5608,6442,419,15324,1704,23470,215143
5153,2020-10-26T17:00:00,ITA,3,Lombardia,45.46679409,9.190347404,2459,242,2701,47624,50325,3570,90356,17252,157933,1711397
5154,2020-10-26T17:00:00,ITA,11,Marche,43.61675973,13.5188753,227,26,253,3669,3922,238,6752,1004,11678,178313
5155,2020-10-26T17:00:00,ITA,14,Molise,41.55774754,14.65916051,19,3,22,618,640,101,651,28,1319,56300
5156,2020-10-26T17:00:00,ITA,21,P.A. Bolzano,46.49933453,11.35662422,152,12,164,3337,3501,321,2955,299,6755,114559
5157,2020-10-26T17:00:00,ITA,22,P.A. Trento,46.06893511,11.12123097,81,5,86,1354,1440,113,6039,426,7905,111484
5158,2020-10-26T17:00:00,ITA,1,Piemonte,45.0732745,7.680687483,1849,102,1951,19316,21267,1625,31620,4273,57160,574505
5159,2020-10-26T17:00:00,ITA,16,Puglia,41.12559576,16.86736689,589,59,648,7631,8279,424,6018,673,14970,372347
5160,2020-10-26T17:00:00,ITA,20,Sardegna,39.21531192,9.110616306,303,35,338,4582,4920,231,2878,192,7990,213063
5161,2020-10-26T17:00:00,ITA,19,Sicilia,38.11569725,13.3623567,677,98,775,10170,10945,568,6081,439,17465,459725
5162,2020-10-26T17:00:00,ITA,9,Toscana,43.76923077,11.25588885,779,110,889,18487,19376,2171,12810,1275,33461,680058
5163,2020-10-26T17:00:00,ITA,10,Umbria,43.10675841,12.38824698,239,31,270,4313,4583,263,2867,108,7558,162797
5164,2020-10-26T17:00:00,ITA,2,Valle d'Aosta,45.73750286,7.320149366,75,2,77,1239,1316,144,1199,154,2669,24533
5165,2020-10-26T17:00:00,ITA,5,Veneto,45.43490485,12.33845213,612,76,688,17359,18047,1129,25087,2332,45466,874701
5166,2020-10-27T17:00:00,ITA,13,Abruzzo,42.35122196,13.39843823,284,22,306,4303,4609,345,3618,532,8759,170530
5167,2020-10-27T17:00:00,ITA,17,Basilicata,40.63947052,15.80514834,68,7,75,1001,1076,77,661,44,1781,96865
5168,2020-10-27T17:00:00,ITA,18,Calabria,38.90597598,16.59440194,117,9,126,2199,2325,234,1768,111,4204,260697
5169,2020-10-27T17:00:00,ITA,15,Campania,40.83956555,14.25084984,1210,140,1350,31491,32841,2761,9907,607,43355,602980
5170,2020-10-27T17:00:00,ITA,8,Emilia-Romagna,44.49436681,11.3417208,934,103,1037,16043,17080,1413,27626,4579,49285,818615
5171,2020-10-27T17:00:00,ITA,6,Friuli Venezia Giulia,45.6494354,13.76813649,139,31,170,3275,3445,241,4913,378,8736,222085
5172,2020-10-27T17:00:00,ITA,12,Lazio,41.89277044,12.48366722,1632,166,1798,24344,26142,1993,10648,1139,37929,1091869
5173,2020-10-27T17:00:00,ITA,7,Liguria,44.41149315,8.9326992,837,45,882,6075,6957,1127,15922,1718,24597,218449
5174,2020-10-27T17:00:00,ITA,3,Lombardia,45.46679409,9.190347404,2715,271,2986,51898,54884,5035,90774,17310,162968,1729725
5175,2020-10-27T17:00:00,ITA,11,Marche,43.61675973,13.5188753,250,28,278,3947,4225,380,6827,1006,12058,179841
5176,2020-10-27T17:00:00,ITA,14,Molise,41.55774754,14.65916051,17,4,21,671,692,66,664,29,1385,56971
5177,2020-10-27T17:00:00,ITA,21,P.A. Bolzano,46.49933453,11.35662422,169,12,181,3557,3738,242,2959,300,6997,115563
5178,2020-10-27T17:00:00,ITA,22,P.A. Trento,46.06893511,11.12123097,84,5,89,1559,1648,257,6087,427,8162,111986
5179,2020-10-27T17:00:00,ITA,1,Piemonte,45.0732745,7.680687483,2016,121,2137,21103,23240,2458,32092,4286,59618,585298
5180,2020-10-27T17:00:00,ITA,16,Puglia,41.12559576,16.86736689,635,62,697,8011,8708,611,6187,686,15581,377074
5181,2020-10-27T17:00:00,ITA,20,Sardegna,39.21531192,9.110616306,306,36,342,4719,5061,174,2904,199,8164,215251
5182,2020-10-27T17:00:00,ITA,19,Sicilia,38.11569725,13.3623567,727,103,830,10904,11734,860,6142,449,18325,464116
5183,2020-10-27T17:00:00,ITA,9,Toscana,43.76923077,11.25588885,804,119,923,20117,21040,1823,12954,1290,35284,688497
5184,2020-10-27T17:00:00,ITA,10,Umbria,43.10675841,12.38824698,248,37,285,4476,4761,314,3001,110,7872,164539
5185,2020-10-27T17:00:00,ITA,2,Valle d'Aosta,45.73750286,7.320149366,99,7,106,1261,1367,57,1203,156,2726,24643
5186,2020-10-27T17:00:00,ITA,5,Veneto,45.43490485,12.33845213,664,83,747,18770,19517,1526,25131,2344,46992,880224
5187,2020-10-28T17:00:00,ITA,13,Abruzzo,42.35122196,13.39843823,306,26,332,4697,5029,434,3630,534,9193,172659
5188,2020-10-28T17:00:00,ITA,17,Basilicata,40.63947052,15.80514834,73,7,80,1104,1184,120,670,47,1901,98626
5189,2020-10-28T17:00:00,ITA,18,Calabria,38.90597598,16.59440194,120,11,131,2373,2504,196,1785,111,4400,263352
5190,2020-10-28T17:00:00,ITA,15,Campania,40.83956555,14.25084984,1235,160,1395,33491,34886,2427,10272,624,45782,611945
5191,2020-10-28T17:00:00,ITA,8,Emilia-Romagna,44.49436681,11.3417208,999,119,1118,17112,18230,1212,27671,4593,50494,827354
5192,2020-10-28T17:00:00,ITA,6,Friuli Venezia Giulia,45.6494354,13.76813649,146,35,181,3551,3732,406,5028,382,9142,223790
5193,2020-10-28T17:00:00,ITA,12,Lazio,41.89277044,12.48366722,1669,166,1835,26111,27946,1963,10788,1158,39892,1111817
5194,2020-10-28T17:00:00,ITA,7,Liguria,44.41149315,8.9326992,878,46,924,6554,7478,926,16312,1733,25523,221286
5195,2020-10-28T17:00:00,ITA,3,Lombardia,45.46679409,9.190347404,3072,292,3364,58042,61406,7558,91763,17357,170526,1755084
5196,2020-10-28T17:00:00,ITA,11,Marche,43.61675973,13.5188753,250,32,282,4244,4526,351,6875,1008,12409,181572
5197,2020-10-28T17:00:00,ITA,14,Molise,41.55774754,14.65916051,19,4,23,676,699,19,674,31,1404,57441
5198,2020-10-28T17:00:00,ITA,21,P.A. Bolzano,46.49933453,11.35662422,181,15,196,3725,3921,190,2962,304,7187,116456
5199,2020-10-28T17:00:00,ITA,22,P.A. Trento,46.06893511,11.12123097,94,6,100,1667,1767,191,6154,432,8353,112387
5200,2020-10-28T17:00:00,ITA,1,Piemonte,45.0732745,7.680687483,2237,135,2372,23415,25787,2827,32353,4305,62445,599224
5201,2020-10-28T17:00:00,ITA,16,Puglia,41.12559576,16.86736689,690,70,760,8677,9437,772,6217,699,16353,383008
5202,2020-10-28T17:00:00,ITA,20,Sardegna,39.21531192,9.110616306,298,37,335,5013,5348,362,2973,205,8526,218343
5203,2020-10-28T17:00:00,ITA,19,Sicilia,38.11569725,13.3623567,787,111,898,11290,12188,708,6386,459,19033,468458
5204,2020-10-28T17:00:00,ITA,9,Toscana,43.76923077,11.25588885,857,130,987,21373,22360,1708,13335,1297,36992,696653
5205,2020-10-28T17:00:00,ITA,10,Umbria,43.10675841,12.38824698,255,37,292,4707,4999,401,3160,114,8273,167083
5206,2020-10-28T17:00:00,ITA,2,Valle d'Aosta,45.73750286,7.320149366,107,7,114,1316,1430,77,1216,157,2803,24935
5207,2020-10-28T17:00:00,ITA,5,Veneto,45.43490485,12.33845213,708,90,798,20802,21600,2143,25180,2355,49135,886165
5208,2020-10-29T17:00:00,ITA,13,Abruzzo,42.35122196,13.39843823,331,26,357,5087,5444,482,3690,540,9674,174707
5209,2020-10-29T17:00:00,ITA,17,Basilicata,40.63947052,15.80514834,74,7,81,1175,1256,86,684,47,1987,99620
5210,2020-10-29T17:00:00,ITA,18,Calabria,38.90597598,16.59440194,134,7,141,2573,2714,225,1798,113,4625,266077
5211,2020-10-29T17:00:00,ITA,15,Campania,40.83956555,14.25084984,1297,164,1461,36243,37704,3103,10537,644,48885,622408
5212,2020-10-29T17:00:00,ITA,8,Emilia-Romagna,44.49436681,11.3417208,1054,123,1177,18536,19713,1545,27724,4601,52038,835830
5213,2020-10-29T17:00:00,ITA,6,Friuli Venezia Giulia,45.6494354,13.76813649,152,34,186,3922,4108,468,5115,387,9610,225536
5214,2020-10-29T17:00:00,ITA,12,Lazio,41.89277044,12.48366722,1786,168,1954,27758,29712,1995,11002,1173,41887,1132105
5215,2020-10-29T17:00:00,ITA,7,Liguria,44.41149315,8.9326992,907,50,957,6979,7936,1018,16863,1742,26541,224168
5216,2020-10-29T17:00:00,ITA,3,Lombardia,45.46679409,9.190347404,3355,345,3700,64184,67884,7339,92567,17414,177865,1780305
5217,2020-10-29T17:00:00,ITA,11,Marche,43.61675973,13.5188753,247,39,286,4850,5136,686,6950,1009,13095,183944
5218,2020-10-29T17:00:00,ITA,14,Molise,41.55774754,14.65916051,19,4,23,768,791,94,675,32,1498,58031
5219,2020-10-29T17:00:00,ITA,21,P.A. Bolzano,46.49933453,11.35662422,193,15,208,4009,4217,298,2962,306,7485,117659
5220,2020-10-29T17:00:00,ITA,22,P.A. Trento,46.06893511,11.12123097,109,9,118,1503,1621,173,6470,435,8526,112836
5221,2020-10-29T17:00:00,ITA,1,Piemonte,45.0732745,7.680687483,2381,146,2527,25364,27891,2585,32807,4332,65030,609925
5222,2020-10-29T17:00:00,ITA,16,Puglia,41.12559576,16.86736689,669,78,747,9255,10002,716,6361,706,17069,386874
5223,2020-10-29T17:00:00,ITA,20,Sardegna,39.21531192,9.110616306,322,39,361,5205,5566,282,3035,207,8808,221404
5224,2020-10-29T17:00:00,ITA,19,Sicilia,38.11569725,13.3623567,839,115,954,11791,12745,789,6605,472,19822,472930
5225,2020-10-29T17:00:00,ITA,9,Toscana,43.76923077,11.25588885,956,137,1093,22877,23970,1966,13678,1310,38958,706557
5226,2020-10-29T17:00:00,ITA,10,Umbria,43.10675841,12.38824698,260,41,301,5270,5571,694,3277,119,8967,169837
5227,2020-10-29T17:00:00,ITA,2,Valle d'Aosta,45.73750286,7.320149366,120,7,127,1457,1584,178,1235,162,2981,25235
5228,2020-10-29T17:00:00,ITA,5,Veneto,45.43490485,12.33845213,759,97,856,22770,23626,2109,25247,2371,51244,890507
5229,2020-10-30T17:00:00,ITA,13,Abruzzo,42.35122196,13.39843823,355,27,382,5414,5796,428,3764,542,10102,176636
5230,2020-10-30T17:00:00,ITA,17,Basilicata,40.63947052,15.80514834,74,7,81,1254,1335,95,699,48,2082,101446
5231,2020-10-30T17:00:00,ITA,18,Calabria,38.90597598,16.59440194,142,9,151,2799,2950,239,1799,114,4863,268922
5232,2020-10-30T17:00:00,ITA,15,Campania,40.83956555,14.25084984,1385,161,1546,38804,40350,3186,11062,659,52071,634861
5233,2020-10-30T17:00:00,ITA,8,Emilia-Romagna,44.49436681,11.3417208,1157,119,1276,20145,21421,1763,27764,4612,53797,842483
5234,2020-10-30T17:00:00,ITA,6,Friuli Venezia Giulia,45.6494354,13.76813649,161,35,196,4339,4535,505,5186,394,10115,227470
5235,2020-10-30T17:00:00,ITA,12,Lazio,41.89277044,12.48366722,1873,175,2048,29699,31747,2246,11196,1190,44133,1152217
5236,2020-10-30T17:00:00,ITA,7,Liguria,44.41149315,8.9326992,948,52,1000,7322,8322,999,17469,1749,27540,226812
5237,2020-10-30T17:00:00,ITA,3,Lombardia,45.46679409,9.190347404,3698,370,4068,71161,75229,8960,94134,17462,186825,1807884
5238,2020-10-30T17:00:00,ITA,11,Marche,43.61675973,13.5188753,262,39,301,5340,5641,524,6965,1013,13619,185912
5239,2020-10-30T17:00:00,ITA,14,Molise,41.55774754,14.65916051,18,6,24,864,888,114,692,32,1612,58819
5240,2020-10-30T17:00:00,ITA,21,P.A. Bolzano,46.49933453,11.35662422,233,18,251,4310,4561,350,2966,308,7835,118867
5241,2020-10-30T17:00:00,ITA,22,P.A. Trento,46.06893511,11.12123097,118,9,127,1562,1689,222,6622,437,8748,113372
5242,2020-10-30T17:00:00,ITA,1,Piemonte,45.0732745,7.680687483,2547,159,2706,27682,30388,2719,33006,4355,67749,623529
5243,2020-10-30T17:00:00,ITA,16,Puglia,41.12559576,16.86736689,634,84,718,9981,10699,791,6448,713,17860,391765
5244,2020-10-30T17:00:00,ITA,20,Sardegna,39.21531192,9.110616306,323,40,363,5458,5821,298,3071,214,9106,224602
5245,2020-10-30T17:00:00,ITA,19,Sicilia,38.11569725,13.3623567,895,117,1012,12552,13564,984,6758,484,20806,477579
5246,2020-10-30T17:00:00,ITA,9,Toscana,43.76923077,11.25588885,1007,153,1160,25260,26420,2765,13983,1320,41723,717521
5247,2020-10-30T17:00:00,ITA,10,Umbria,43.10675841,12.38824698,260,42,302,5864,6166,729,3409,121,9696,171539
5248,2020-10-30T17:00:00,ITA,2,Valle d'Aosta,45.73750286,7.320149366,127,7,134,1583,1717,155,1253,166,3136,25710
5249,2020-10-30T17:00:00,ITA,5,Veneto,45.43490485,12.33845213,777,117,894,25653,26547,3012,25321,2388,54256,898237
5250,2020-10-31T17:00:00,ITA,13,Abruzzo,42.35122196,13.39843823,371,29,400,5803,6203,450,3799,550,10552,178791
5251,2020-10-31T17:00:00,ITA,17,Basilicata,40.63947052,15.80514834,83,7,90,1356,1446,117,704,49,2199,103139
5252,2020-10-31T17:00:00,ITA,18,Calabria,38.90597598,16.59440194,154,9,163,2961,3124,202,1825,116,5065,271920
5253,2020-10-31T17:00:00,ITA,15,Campania,40.83956555,14.25084984,1403,168,1571,42159,43730,3669,11337,673,55740,651607
5254,2020-10-31T17:00:00,ITA,8,Emilia-Romagna,44.49436681,11.3417208,1223,125,1348,21865,23213,2046,27997,4631,55841,849335
5255,2020-10-31T17:00:00,ITA,6,Friuli Venezia Giulia,45.6494354,13.76813649,167,36,203,4929,5132,726,5312,397,10841,229633
5256,2020-10-31T17:00:00,ITA,12,Lazio,41.89277044,12.48366722,1944,182,2126,31780,33906,2289,11304,1212,46422,1174268
5257,2020-10-31T17:00:00,ITA,7,Liguria,44.41149315,8.9326992,1036,57,1093,7338,8431,1068,18403,1774,28608,229381
5258,2020-10-31T17:00:00,ITA,3,Lombardia,45.46679409,9.190347404,4033,392,4425,77586,82011,8919,96198,17535,195744,1834360
5259,2020-10-31T17:00:00,ITA,11,Marche,43.61675973,13.5188753,275,47,322,5783,6105,502,6997,1019,14121,187640
5260,2020-10-31T17:00:00,ITA,14,Molise,41.55774754,14.65916051,17,6,23,933,956,83,702,37,1695,59452
5261,2020-10-31T17:00:00,ITA,21,P.A. Bolzano,46.49933453,11.35662422,237,18,255,4845,5100,547,2970,312,8382,120339
5262,2020-10-31T17:00:00,ITA,22,P.A. Trento,46.06893511,11.12123097,121,9,130,1795,1925,390,6775,438,9138,114145
5263,2020-10-31T17:00:00,ITA,1,Piemonte,45.0732745,7.680687483,2683,174,2857,29967,32824,2887,33429,4383,70636,636308
5264,2020-10-31T17:00:00,ITA,16,Puglia,41.12559576,16.86736689,638,87,725,10668,11393,762,6506,723,18622,396687
5265,2020-10-31T17:00:00,ITA,20,Sardegna,39.21531192,9.110616306,349,39,388,5667,6055,325,3149,227,9431,227323
5266,2020-10-31T17:00:00,ITA,19,Sicilia,38.11569725,13.3623567,962,122,1084,13358,14442,952,6814,502,21758,482882
5267,2020-10-31T17:00:00,ITA,9,Toscana,43.76923077,11.25588885,1046,163,1209,26635,27844,2540,15074,1345,44263,727110
5268,2020-10-31T17:00:00,ITA,10,Umbria,43.10675841,12.38824698,277,43,320,6234,6554,483,3499,126,10179,173851
5269,2020-10-31T17:00:00,ITA,2,Valle d'Aosta,45.73750286,7.320149366,146,7,153,1660,1813,104,1259,168,3240,25954
5270,2020-10-31T17:00:00,ITA,5,Veneto,45.43490485,12.33845213,801,123,924,28255,29179,2697,25373,2401,56953,904337
5271,2020-11-01T17:00:00,ITA,13,Abruzzo,42.35122196,13.39843823,391,32,423,6210,6633,489,3854,554,11041,180627
5272,2020-11-01T17:00:00,ITA,17,Basilicata,40.63947052,15.80514834,86,11,97,1498,1595,150,705,49,2349,104650
5273,2020-11-01T17:00:00,ITA,18,Calabria,38.90597598,16.59440194,161,13,174,3188,3362,245,1831,117,5310,274781
5274,2020-11-01T17:00:00,ITA,15,Campania,40.83956555,14.25084984,1416,170,1586,45592,47178,3860,11746,676,59600,669472
5275,2020-11-01T17:00:00,ITA,8,Emilia-Romagna,44.49436681,11.3417208,1267,132,1399,23518,24917,1758,28033,4647,57597,858385
5276,2020-11-01T17:00:00,ITA,6,Friuli Venezia Giulia,45.6494354,13.76813649,180,38,218,5158,5376,403,5470,398,11244,230864
5277,2020-11-01T17:00:00,ITA,12,Lazio,41.89277044,12.48366722,2055,185,2240,33866,36106,2351,11436,1231,48773,1192749
5278,2020-11-01T17:00:00,ITA,7,Liguria,44.41149315,8.9326992,1080,63,1143,7571,8714,736,18849,1781,29344,231090
5279,2020-11-01T17:00:00,ITA,3,Lombardia,45.46679409,9.190347404,4246,418,4664,85411,90075,8607,96687,17589,204351,1856584
5280,2020-11-01T17:00:00,ITA,11,Marche,43.61675973,13.5188753,327,42,369,6354,6723,683,7060,1021,14804,189574
5281,2020-11-01T17:00:00,ITA,14,Molise,41.55774754,14.65916051,18,5,23,1030,1053,101,703,40,1796,60268
5282,2020-11-01T17:00:00,ITA,21,P.A. Bolzano,46.49933453,11.35662422,273,17,290,5341,5631,534,2970,315,8916,121821
5283,2020-11-01T17:00:00,ITA,22,P.A. Trento,46.06893511,11.12123097,152,9,161,1939,2100,210,6807,441,9348,114652
5284,2020-11-01T17:00:00,ITA,1,Piemonte,45.0732745,7.680687483,2844,179,3023,31391,34414,2024,33852,4394,72660,643829
5285,2020-11-01T17:00:00,ITA,16,Puglia,41.12559576,16.86736689,677,87,764,11268,12032,680,6539,731,19302,400285
5286,2020-11-01T17:00:00,ITA,20,Sardegna,39.21531192,9.110616306,336,43,379,5999,6378,399,3218,234,9830,230042
5287,2020-11-01T17:00:00,ITA,19,Sicilia,38.11569725,13.3623567,999,132,1131,14193,15324,1095,7011,518,22853,488072
5288,2020-11-01T17:00:00,ITA,9,Toscana,43.76923077,11.25588885,1106,173,1279,28695,29974,2379,15305,1363,46642,736419
5289,2020-11-01T17:00:00,ITA,10,Umbria,43.10675841,12.38824698,295,46,341,6869,7210,768,3602,135,10947,175572
5290,2020-11-01T17:00:00,ITA,2,Valle d'Aosta,45.73750286,7.320149366,161,12,173,1747,1920,135,1281,174,3375,26164
5291,2020-11-01T17:00:00,ITA,5,Veneto,45.43490485,12.33845213,832,132,964,30450,31414,2300,25421,2418,59253,910040
5292,2020-11-02T17:00:00,ITA,13,Abruzzo,42.35122196,13.39843823,401,33,434,6657,7091,478,3872,556,11519,182672
5293,2020-11-02T17:00:00,ITA,17,Basilicata,40.63947052,15.80514834,88,13,101,1594,1695,111,714,51,2460,106248
5294,2020-11-02T17:00:00,ITA,18,Calabria,38.90597598,16.59440194,164,19,183,3422,3605,254,1841,118,5564,277221
5295,2020-11-02T17:00:00,ITA,15,Campania,40.83956555,14.25084984,1486,171,1657,47113,48770,2861,12991,700,62461,680120
5296,2020-11-02T17:00:00,ITA,8,Emilia-Romagna,44.49436681,11.3417208,1382,138,1520,24972,26492,1652,28093,4664,59249,865327
5297,2020-11-02T17:00:00,ITA,6,Friuli Venezia Giulia,45.6494354,13.76813649,179,37,216,5337,5553,218,5506,403,11462,231668
5298,2020-11-02T17:00:00,ITA,12,Lazio,41.89277044,12.48366722,2032,185,2217,35566,37783,1859,11595,1254,50632,1207323
5299,2020-11-02T17:00:00,ITA,7,Liguria,44.41149315,8.9326992,1133,57,1190,8104,9294,599,18859,1790,29943,232521
5300,2020-11-02T17:00:00,ITA,3,Lombardia,45.46679409,9.190347404,4406,435,4841,89577,94418,5278,97576,17635,209629,1871538
5301,2020-11-02T17:00:00,ITA,11,Marche,43.61675973,13.5188753,334,50,384,6658,7042,373,7110,1025,15177,190758
5302,2020-11-02T17:00:00,ITA,14,Molise,41.55774754,14.65916051,22,5,27,1126,1153,101,703,41,1897,60969
5303,2020-11-02T17:00:00,ITA,21,P.A. Bolzano,46.49933453,11.35662422,293,23,316,5744,6060,437,2974,319,9353,122791
5304,2020-11-02T17:00:00,ITA,22,P.A. Trento,46.06893511,11.12123097,178,11,189,1980,2169,187,6922,444,9535,115005
5305,2020-11-02T17:00:00,ITA,1,Piemonte,45.0732745,7.680687483,3108,196,3304,32791,36095,2003,34153,4415,74663,652762
5306,2020-11-02T17:00:00,ITA,16,Puglia,41.12559576,16.86736689,705,88,793,11776,12569,626,6619,740,19928,402022
5307,2020-11-02T17:00:00,ITA,20,Sardegna,39.21531192,9.110616306,339,43,382,6271,6653,324,3266,235,10154,232724
5308,2020-11-02T17:00:00,ITA,19,Sicilia,38.11569725,13.3623567,1025,142,1167,14897,16064,1024,7277,536,23877,492862
5309,2020-11-02T17:00:00,ITA,9,Toscana,43.76923077,11.25588885,1217,182,1399,30336,31735,2009,15529,1387,48651,743951
5310,2020-11-02T17:00:00,ITA,10,Umbria,43.10675841,12.38824698,308,46,354,6972,7326,193,3674,140,11140,175793
5311,2020-11-02T17:00:00,ITA,2,Valle d'Aosta,45.73750286,7.320149366,167,12,179,1833,2012,122,1306,179,3497,26356
5312,2020-11-02T17:00:00,ITA,5,Veneto,45.43490485,12.33845213,873,136,1009,31924,32933,1544,25437,2427,60797,912972
5313,2020-11-03T17:00:00,ITA,13,Abruzzo,42.35122196,13.39843823,429,38,467,7180,7647,601,3909,564,12120,184865
5314,2020-11-03T17:00:00,ITA,17,Basilicata,40.63947052,15.80514834,87,11,98,1681,1779,102,729,54,2562,107396
5315,2020-11-03T17:00:00,ITA,18,Calabria,38.90597598,16.59440194,184,26,210,3430,3640,266,2069,121,5830,280076
5316,2020-11-03T17:00:00,ITA,15,Campania,40.83956555,14.25084984,1497,227,1724,48995,50719,2971,13989,724,65432,688589
5317,2020-11-03T17:00:00,ITA,8,Emilia-Romagna,44.49436681,11.3417208,1464,153,1617,26731,28348,1912,28123,4687,61158,874120
5318,2020-11-03T17:00:00,ITA,6,Friuli Venezia Giulia,45.6494354,13.76813649,205,39,244,5514,5758,366,5659,411,11828,233148
5319,2020-11-03T17:00:00,ITA,12,Lazio,41.89277044,12.48366722,2192,197,2389,37340,39729,2209,11837,1275,52841,1227238
5320,2020-11-03T17:00:00,ITA,7,Liguria,44.41149315,8.9326992,1147,64,1211,8618,9829,1052,19356,1810,30995,235736
5321,2020-11-03T17:00:00,ITA,3,Lombardia,45.46679409,9.190347404,4740,475,5215,93351,98566,6804,100115,17752,216433,1889116
5322,2020-11-03T17:00:00,ITA,11,Marche,43.61675973,13.5188753,374,53,427,6990,7417,431,7160,1031,15608,192435
5323,2020-11-03T17:00:00,ITA,14,Molise,41.55774754,14.65916051,24,6,30,1214,1244,93,705,41,1990,61642
5324,2020-11-03T17:00:00,ITA,21,P.A. Bolzano,46.49933453,11.35662422,287,28,315,6237,6552,495,2976,320,9848,123854
5325,2020-11-03T17:00:00,ITA,22,P.A. Trento,46.06893511,11.12123097,200,12,212,2050,2262,112,6938,447,9647,115196
5326,2020-11-03T17:00:00,ITA,1,Piemonte,45.0732745,7.680687483,3379,213,3592,35121,38713,3169,34675,4444,77832,664753
5327,2020-11-03T17:00:00,ITA,16,Puglia,41.12559576,16.86736689,749,95,844,12681,13525,1163,6813,753,21091,408246
5328,2020-11-03T17:00:00,ITA,20,Sardegna,39.21531192,9.110616306,337,45,382,6526,6908,302,3309,239,10456,234643
5329,2020-11-03T17:00:00,ITA,19,Sicilia,38.11569725,13.3623567,1072,150,1222,15584,16806,1048,7569,550,24925,497218
5330,2020-11-03T17:00:00,ITA,9,Toscana,43.76923077,11.25588885,1261,190,1451,32466,33917,2336,15667,1403,50987,753032
5331,2020-11-03T17:00:00,ITA,10,Umbria,43.10675841,12.38824698,305,48,353,7214,7567,420,3845,148,11560,178056
5332,2020-11-03T17:00:00,ITA,2,Valle d'Aosta,45.73750286,7.320149366,170,13,183,1867,2050,94,1361,180,3591,26492
5333,2020-11-03T17:00:00,ITA,5,Veneto,45.43490485,12.33845213,1011,142,1153,34013,35166,2298,25471,2458,63095,917684
5334,2020-11-04T17:00:00,ITA,13,Abruzzo,42.35122196,13.39843823,427,36,463,7569,8032,423,3943,568,12543,186722
5335,2020-11-04T17:00:00,ITA,17,Basilicata,40.63947052,15.80514834,89,15,104,1890,1994,226,740,54,2788,109034
5336,2020-11-04T17:00:00,ITA,18,Calabria,38.90597598,16.59440194,212,11,223,3670,3893,262,2074,124,6092,282942
5337,2020-11-04T17:00:00,ITA,15,Campania,40.83956555,14.25084984,1569,175,1744,52744,54488,4181,14386,739,69613,706058
5338,2020-11-04T17:00:00,ITA,8,Emilia-Romagna,44.49436681,11.3417208,1554,161,1715,28259,29974,1758,28241,4699,62914,882474
5339,2020-11-04T17:00:00,ITA,6,Friuli Venezia Giulia,45.6494354,13.76813649,215,40,255,5726,5981,436,5869,414,12264,234748
5340,2020-11-04T17:00:00,ITA,12,Lazio,41.89277044,12.48366722,2317,217,2534,39349,41883,2432,12081,1309,55273,1249929
5341,2020-11-04T17:00:00,ITA,7,Liguria,44.41149315,8.9326992,1196,77,1273,9194,10467,1122,19816,1834,32117,238930
5342,2020-11-04T17:00:00,ITA,3,Lombardia,45.46679409,9.190347404,5018,507,5525,99208,104733,7758,101610,17848,224191,1912351
5343,2020-11-04T17:00:00,ITA,11,Marche,43.61675973,13.5188753,398,54,452,7546,7998,653,7231,1032,16261,194702
5344,2020-11-04T17:00:00,ITA,14,Molise,41.55774754,14.65916051,28,7,35,1207,1242,26,733,41,2016,62366
5345,2020-11-04T17:00:00,ITA,21,P.A. Bolzano,46.49933453,11.35662422,309,33,342,6454,6796,249,2979,322,10097,124578
5346,2020-11-04T17:00:00,ITA,22,P.A. Trento,46.06893511,11.12123097,211,11,222,2096,2318,225,7103,451,9872,115721
5347,2020-11-04T17:00:00,ITA,1,Piemonte,45.0732745,7.680687483,3525,233,3758,37819,41577,3577,35351,4481,81409,675549
5348,2020-11-04T17:00:00,ITA,16,Puglia,41.12559576,16.86736689,745,116,861,13372,14233,994,7089,763,22085,412674
5349,2020-11-04T17:00:00,ITA,20,Sardegna,39.21531192,9.110616306,344,45,389,6659,7048,184,3351,241,10640,236425
5350,2020-11-04T17:00:00,ITA,19,Sicilia,38.11569725,13.3623567,1105,148,1253,16365,17618,1155,7893,569,26080,503610
5351,2020-11-04T17:00:00,ITA,9,Toscana,43.76923077,11.25588885,1319,197,1516,33948,35464,1828,15890,1445,52815,760985
5352,2020-11-04T17:00:00,ITA,10,Umbria,43.10675841,12.38824698,307,49,356,7480,7836,496,4066,154,12056,180154
5353,2020-11-04T17:00:00,ITA,2,Valle d'Aosta,45.73750286,7.320149366,152,11,163,1961,2124,129,1415,181,3720,26668
5354,2020-11-04T17:00:00,ITA,5,Veneto,45.43490485,12.33845213,1076,149,1225,36311,37536,2436,25517,2478,65531,924415
5355,2020-11-05T17:00:00,ITA,13,Abruzzo,42.35122196,13.39843823,458,36,494,7770,8264,571,4273,577,13114,188627
5356,2020-11-05T17:00:00,ITA,17,Basilicata,40.63947052,15.80514834,90,16,106,2015,2121,135,746,56,2923,110599
5357,2020-11-05T17:00:00,ITA,18,Calabria,38.90597598,16.59440194,217,11,228,4016,4244,358,2078,128,6450,286339
5358,2020-11-05T17:00:00,ITA,15,Campania,40.83956555,14.25084984,1608,174,1782,56266,58048,3888,14697,756,73501,721021
5359,2020-11-05T17:00:00,ITA,8,Emilia-Romagna,44.49436681,11.3417208,1588,177,1765,30211,31976,2180,28403,4712,65091,890032
5360,2020-11-05T17:00:00,ITA,6,Friuli Venezia Giulia,45.6494354,13.76813649,268,44,312,6067,6379,546,6008,423,12810,236298
5361,2020-11-05T17:00:00,ITA,12,Lazio,41.89277044,12.48366722,2508,222,2730,41560,44290,2735,12374,1344,58008,1275067
5362,2020-11-05T17:00:00,ITA,7,Liguria,44.41149315,8.9326992,1236,76,1312,9911,11223,1208,20239,1863,33325,241779
5363,2020-11-05T17:00:00,ITA,3,Lombardia,45.46679409,9.190347404,5318,522,5840,106684,112524,8822,102502,17987,233013,1935518
5364,2020-11-05T17:00:00,ITA,11,Marche,43.61675973,13.5188753,421,56,477,8150,8627,698,7298,1034,16959,197050
5365,2020-11-05T17:00:00,ITA,14,Molise,41.55774754,14.65916051,27,7,34,1301,1335,107,746,42,2123,63121
5366,2020-11-05T17:00:00,ITA,21,P.A. Bolzano,46.49933453,11.35662422,335,33,368,7180,7548,762,2985,326,10859,126245
5367,2020-11-05T17:00:00,ITA,22,P.A. Trento,46.06893511,11.12123097,224,15,239,2097,2336,320,7402,454,10192,116471
5368,2020-11-05T17:00:00,ITA,1,Piemonte,45.0732745,7.680687483,3698,249,3947,40027,43974,3171,36086,4520,84580,687826
5369,2020-11-05T17:00:00,ITA,16,Puglia,41.12559576,16.86736689,745,122,867,13956,14823,850,7323,789,22935,419182
5370,2020-11-05T17:00:00,ITA,20,Sardegna,39.21531192,9.110616306,340,46,386,6982,7368,413,3438,247,11053,239432
5371,2020-11-05T17:00:00,ITA,19,Sicilia,38.11569725,13.3623567,1147,157,1304,17222,18526,1322,8282,594,27402,509301
5372,2020-11-05T17:00:00,ITA,9,Toscana,43.76923077,11.25588885,1387,202,1589,35893,37482,2273,16136,1470,55088,771596
5373,2020-11-05T17:00:00,ITA,10,Umbria,43.10675841,12.38824698,319,50,369,8020,8389,768,4270,165,12824,182633
5374,2020-11-05T17:00:00,ITA,2,Valle d'Aosta,45.73750286,7.320149366,160,12,172,1980,2152,114,1493,189,3834,26872
5375,2020-11-05T17:00:00,ITA,5,Veneto,45.43490485,12.33845213,1162,164,1326,39393,40719,3264,25560,2516,68795,930576
5376,2020-11-06T17:00:00,ITA,13,Abruzzo,42.35122196,13.39843823,468,42,510,8071,8581,395,4340,584,13505,190210
5377,2020-11-06T17:00:00,ITA,17,Basilicata,40.63947052,15.80514834,100,16,116,2219,2335,249,778,59,3172,112020
5378,2020-11-06T17:00:00,ITA,18,Calabria,38.90597598,16.59440194,212,15,227,4254,4481,264,2101,132,6714,289214
5379,2020-11-06T17:00:00,ITA,15,Campania,40.83956555,14.25084984,1677,180,1857,60339,62196,4508,15017,796,78009,739433
5380,2020-11-06T17:00:00,ITA,8,Emilia-Romagna,44.49436681,11.3417208,1673,177,1850,31880,33730,1953,28559,4752,67041,897938
5381,2020-11-06T17:00:00,ITA,6,Friuli Venezia Giulia,45.6494354,13.76813649,260,44,304,6451,6755,542,6162,435,13352,238032
5382,2020-11-06T17:00:00,ITA,12,Lazio,41.89277044,12.48366722,2511,234,2745,43939,46684,2699,12653,1370,60707,1296386
5383,2020-11-06T17:00:00,ITA,7,Liguria,44.41149315,8.9326992,1315,78,1393,10299,11692,1127,20881,1879,34452,244325
5384,2020-11-06T17:00:00,ITA,3,Lombardia,45.46679409,9.190347404,5563,570,6133,111233,117366,9934,107463,18118,242947,1960088
5385,2020-11-06T17:00:00,ITA,11,Marche,43.61675973,13.5188753,444,60,504,8736,9240,697,7379,1037,17656,199235
5386,2020-11-06T17:00:00,ITA,14,Molise,41.55774754,14.65916051,26,8,34,1371,1405,76,749,45,2199,63905
5387,2020-11-06T17:00:00,ITA,21,P.A. Bolzano,46.49933453,11.35662422,356,35,391,6655,7046,713,4196,330,11572,127570
5388,2020-11-06T17:00:00,ITA,22,P.A. Trento,46.06893511,11.12123097,226,17,243,2190,2433,261,7561,459,10453,117055
5389,2020-11-06T17:00:00,ITA,1,Piemonte,45.0732745,7.680687483,3871,268,4139,43777,47916,4878,36993,4549,89458,703606
5390,2020-11-06T17:00:00,ITA,16,Puglia,41.12559576,16.86736689,787,122,909,14720,15629,946,7450,802,23881,423213
5391,2020-11-06T17:00:00,ITA,20,Sardegna,39.21531192,9.110616306,392,46,438,7248,7686,359,3477,249,11412,242502
5392,2020-11-06T17:00:00,ITA,19,Sicilia,38.11569725,13.3623567,1157,159,1316,18197,19513,1423,8684,628,28825,514907
5393,2020-11-06T17:00:00,ITA,9,Toscana,43.76923077,11.25588885,1303,209,1512,37928,39440,2592,16738,1502,57680,780994
5394,2020-11-06T17:00:00,ITA,10,Umbria,43.10675841,12.38824698,326,53,379,8506,8885,767,4532,174,13591,185144
5395,2020-11-06T17:00:00,ITA,2,Valle d'Aosta,45.73750286,7.320149366,154,13,167,2001,2168,129,1600,195,3963,27094
5396,2020-11-06T17:00:00,ITA,5,Veneto,45.43490485,12.33845213,1184,169,1353,42584,43937,3297,25612,2543,72092,937280
5397,2020-11-07T17:00:00,ITA,13,Abruzzo,42.35122196,13.39843823,484,43,527,8368,8895,432,4445,596,13936,191808
5398,2020-11-07T17:00:00,ITA,17,Basilicata,40.63947052,15.80514834,98,15,113,2302,2415,105,799,63,3277,113188
5399,2020-11-07T17:00:00,ITA,18,Calabria,38.90597598,16.59440194,227,16,243,4552,4795,392,2175,136,7106,292747
5400,2020-11-07T17:00:00,ITA,15,Campania,40.83956555,14.25084984,1756,179,1935,63571,65506,4309,16001,811,82318,757092
5401,2020-11-07T17:00:00,ITA,8,Emilia-Romagna,44.49436681,11.3417208,1723,188,1911,33738,35649,2009,28619,4781,69049,906435
5402,2020-11-07T17:00:00,ITA,6,Friuli Venezia Giulia,45.6494354,13.76813649,286,45,331,7029,7360,872,6422,442,14224,240788
5403,2020-11-07T17:00:00,ITA,12,Lazio,41.89277044,12.48366722,2619,237,2856,46180,49036,2618,12892,1397,63325,1322844
5404,2020-11-07T17:00:00,ITA,7,Liguria,44.41149315,8.9326992,1303,77,1380,10728,12108,1092,21522,1914,35544,246833
5405,2020-11-07T17:00:00,ITA,3,Lombardia,45.46679409,9.190347404,5813,610,6423,121206,127629,11489,108581,18226,254436,1981508
5406,2020-11-07T17:00:00,ITA,11,Marche,43.61675973,13.5188753,454,67,521,9306,9827,631,7415,1045,18287,201310
5407,2020-11-07T17:00:00,ITA,14,Molise,41.55774754,14.65916051,26,8,34,1523,1557,152,749,45,2351,64689
5408,2020-11-07T17:00:00,ITA,21,P.A. Bolzano,46.49933453,11.35662422,361,36,397,7083,7480,773,4528,337,12345,129251
5409,2020-11-07T17:00:00,ITA,22,P.A. Trento,46.06893511,11.12123097,243,18,261,2357,2618,251,7622,464,10704,117513
5410,2020-11-07T17:00:00,ITA,1,Piemonte,45.0732745,7.680687483,4122,284,4406,47083,51489,4437,37812,4594,93895,715993
5411,2020-11-07T17:00:00,ITA,16,Puglia,41.12559576,16.86736689,876,124,1000,15573,16573,1054,7546,816,24935,430276
5412,2020-11-07T17:00:00,ITA,20,Sardegna,39.21531192,9.110616306,390,56,446,7625,8071,425,3513,253,11837,245123
5413,2020-11-07T17:00:00,ITA,19,Sicilia,38.11569725,13.3623567,1161,169,1330,19407,20737,1363,8788,663,30188,520508
5414,2020-11-07T17:00:00,ITA,9,Toscana,43.76923077,11.25588885,1368,214,1582,40001,41583,2787,17352,1532,60467,791081
5415,2020-11-07T17:00:00,ITA,10,Umbria,43.10675841,12.38824698,345,58,403,8967,9370,688,4731,178,14279,187400
5416,2020-11-07T17:00:00,ITA,2,Valle d'Aosta,45.73750286,7.320149366,154,14,168,2013,2181,117,1697,202,4080,27267
5417,2020-11-07T17:00:00,ITA,5,Veneto,45.43490485,12.33845213,1300,176,1476,46181,47657,3815,25682,2568,75907,944143
5418,2020-11-08T17:00:00,ITA,13,Abruzzo,42.35122196,13.39843823,484,43,527,8804,9331,584,4592,596,14519,193373
5419,2020-11-08T17:00:00,ITA,17,Basilicata,40.63947052,15.80514834,102,16,118,2536,2654,246,805,64,3523,114414
5420,2020-11-08T17:00:00,ITA,18,Calabria,38.90597598,16.59440194,233,16,249,4771,5020,359,2305,140,7465,295866
5421,2020-11-08T17:00:00,ITA,15,Campania,40.83956555,14.25084984,1817,186,2003,67649,69652,4601,16441,826,86919,778735
5422,2020-11-08T17:00:00,ITA,8,Emilia-Romagna,44.49436681,11.3417208,1836,194,2030,35822,37852,2360,28740,4816,71408,914731
5423,2020-11-08T17:00:00,ITA,6,Friuli Venezia Giulia,45.6494354,13.76813649,301,45,346,7295,7641,504,6636,451,14728,242297
5424,2020-11-08T17:00:00,ITA,12,Lazio,41.89277044,12.48366722,2686,237,2923,48455,51378,2489,13023,1413,65814,1341488
5425,2020-11-08T17:00:00,ITA,7,Liguria,44.41149315,8.9326992,1334,81,1415,10993,12408,886,22106,1916,36430,248706
5426,2020-11-08T17:00:00,ITA,3,Lombardia,45.46679409,9.190347404,6225,650,6875,125535,132410,6318,110001,18343,260754,2003397
5427,2020-11-08T17:00:00,ITA,11,Marche,43.61675973,13.5188753,493,69,562,9679,10241,502,7498,1050,18789,202915
5428,2020-11-08T17:00:00,ITA,14,Molise,41.55774754,14.65916051,39,7,46,1596,1642,91,752,48,2442,65390
5429,2020-11-08T17:00:00,ITA,21,P.A. Bolzano,46.49933453,11.35662422,398,39,437,7550,7987,781,4798,341,13126,130323
5430,2020-11-08T17:00:00,ITA,22,P.A. Trento,46.06893511,11.12123097,255,20,275,2478,2753,182,7668,465,10886,117848
5431,2020-11-08T17:00:00,ITA,1,Piemonte,45.0732745,7.680687483,4367,304,4671,49526,54197,3884,38953,4629,97779,726199
5432,2020-11-08T17:00:00,ITA,16,Puglia,41.12559576,16.86736689,880,123,1003,16184,17187,766,7677,837,25701,433213
5433,2020-11-08T17:00:00,ITA,20,Sardegna,39.21531192,9.110616306,400,55,455,7972,8427,424,3579,255,12261,248373
5434,2020-11-08T17:00:00,ITA,19,Sicilia,38.11569725,13.3623567,1250,177,1427,20040,21467,1083,9128,676,31271,525013
5435,2020-11-08T17:00:00,ITA,9,Toscana,43.76923077,11.25588885,1474,226,1700,41747,43447,2479,17938,1561,62946,799345
5436,2020-11-08T17:00:00,ITA,10,Umbria,43.10675841,12.38824698,353,62,415,9385,9800,660,4951,188,14939,189320
5437,2020-11-08T17:00:00,ITA,2,Valle d'Aosta,45.73750286,7.320149366,158,14,172,2000,2172,55,1758,205,4135,27399
5438,2020-11-08T17:00:00,ITA,5,Veneto,45.43490485,12.33845213,1355,185,1540,49430,50970,3362,25725,2574,79269,948701
5439,2020-11-09T17:00:00,ITA,13,Abruzzo,42.35122196,13.39843823,513,48,561,9311,9872,625,4669,602,15143,195550
5440,2020-11-09T17:00:00,ITA,17,Basilicata,40.63947052,15.80514834,111,18,129,2648,2777,132,814,64,3655,115245
5441,2020-11-09T17:00:00,ITA,18,Calabria,38.90597598,16.59440194,256,16,272,5173,5445,443,2319,144,7908,298062
5442,2020-11-09T17:00:00,ITA,15,Campania,40.83956555,14.25084984,1949,191,2140,70180,72320,3120,16875,844,90039,789173
5443,2020-11-09T17:00:00,ITA,8,Emilia-Romagna,44.49436681,11.3417208,1939,204,2143,37487,39630,2025,28978,4824,73432,922303
5444,2020-11-09T17:00:00,ITA,6,Friuli Venezia Giulia,45.6494354,13.76813649,319,46,365,7467,7832,320,6760,456,15048,243252
5445,2020-11-09T17:00:00,ITA,12,Lazio,41.89277044,12.48366722,2761,237,2998,50276,53274,2153,13264,1429,67967,1357006
5446,2020-11-09T17:00:00,ITA,7,Liguria,44.41149315,8.9326992,1387,92,1479,11242,12721,538,22310,1937,36968,249942
5447,2020-11-09T17:00:00,ITA,3,Lombardia,45.46679409,9.190347404,6414,670,7084,124375,131459,4777,115630,18442,265531,2014134
5448,2020-11-09T17:00:00,ITA,11,Marche,43.61675973,13.5188753,519,71,590,9861,10451,262,7543,1057,19051,203665
5449,2020-11-09T17:00:00,ITA,14,Molise,41.55774754,14.65916051,38,7,45,1615,1660,98,831,49,2540,66276
5450,2020-11-09T17:00:00,ITA,21,P.A. Bolzano,46.49933453,11.35662422,411,41,452,7962,8414,583,4950,345,13709,131696
5451,2020-11-09T17:00:00,ITA,22,P.A. Trento,46.06893511,11.12123097,275,24,299,2675,2974,257,7698,471,11143,118318
5452,2020-11-09T17:00:00,ITA,1,Piemonte,45.0732745,7.680687483,4540,312,4852,51404,56256,2876,39721,4678,100655,735109
5453,2020-11-09T17:00:00,ITA,16,Puglia,41.12559576,16.86736689,968,119,1087,16726,17813,730,7774,844,26431,437142
5454,2020-11-09T17:00:00,ITA,20,Sardegna,39.21531192,9.110616306,408,58,466,8127,8593,327,3727,268,12588,250888
5455,2020-11-09T17:00:00,ITA,19,Sicilia,38.11569725,13.3623567,1303,187,1490,20449,21939,1023,9652,703,32294,529908
5456,2020-11-09T17:00:00,ITA,9,Toscana,43.76923077,11.25588885,1542,234,1776,42704,44480,2244,19116,1594,65190,806480
5457,2020-11-09T17:00:00,ITA,10,Umbria,43.10675841,12.38824698,360,64,424,9572,9996,314,5060,197,15253,189991
5458,2020-11-09T17:00:00,ITA,2,Valle d'Aosta,45.73750286,7.320149366,159,15,174,2092,2266,201,1863,207,4336,27671
5459,2020-11-09T17:00:00,ITA,5,Veneto,45.43490485,12.33845213,1464,195,1659,51503,53162,2223,25735,2595,81492,953936
5460,2020-11-10T17:00:00,ITA,13,Abruzzo,42.35122196,13.39843823,530,46,576,9852,10428,746,4832,628,15888,197902
5461,2020-11-10T17:00:00,ITA,17,Basilicata,40.63947052,15.80514834,138,18,156,2831,2987,224,826,66,3879,116796
5462,2020-11-10T17:00:00,ITA,18,Calabria,38.90597598,16.59440194,283,19,302,5545,5847,409,2319,151,8317,301133
5463,2020-11-10T17:00:00,ITA,15,Campania,40.83956555,14.25084984,2061,193,2254,71974,74228,2716,17665,862,92755,800240
5464,2020-11-10T17:00:00,ITA,8,Emilia-Romagna,44.49436681,11.3417208,2020,215,2235,39545,41780,2430,29230,4845,75855,931259
5465,2020-11-10T17:00:00,ITA,6,Friuli Venezia Giulia,45.6494354,13.76813649,336,47,383,7458,7841,482,7213,476,15530,245027
5466,2020-11-10T17:00:00,ITA,12,Lazio,41.89277044,12.48366722,2785,257,3042,52547,55589,2608,13521,1465,70575,1381230
5467,2020-11-10T17:00:00,ITA,7,Liguria,44.41149315,8.9326992,1315,92,1407,11929,13336,1172,22828,1976,38140,253455
5468,2020-11-10T17:00:00,ITA,3,Lombardia,45.46679409,9.190347404,6682,708,7390,128115,135505,10955,122410,18571,276486,2039672
5469,2020-11-10T17:00:00,ITA,11,Marche,43.61675973,13.5188753,525,75,600,10289,10889,504,7599,1067,19555,205090
5470,2020-11-10T17:00:00,ITA,14,Molise,41.55774754,14.65916051,44,7,51,1641,1692,42,834,56,2582,66672
5471,2020-11-10T17:00:00,ITA,21,P.A. Bolzano,46.49933453,11.35662422,427,37,464,8199,8663,375,5071,350,14084,132488
5472,2020-11-10T17:00:00,ITA,22,P.A. Trento,46.06893511,11.12123097,290,28,318,2491,2809,243,8100,477,11386,118965
5473,2020-11-10T17:00:00,ITA,1,Piemonte,45.0732745,7.680687483,4715,325,5040,53795,58835,3659,40737,4742,104314,745706
5474,2020-11-10T17:00:00,ITA,16,Puglia,41.12559576,16.86736689,1029,131,1160,17726,18886,1245,7921,869,27676,443227
5475,2020-11-10T17:00:00,ITA,20,Sardegna,39.21531192,9.110616306,403,51,454,8506,8960,489,3838,279,13077,254265
5476,2020-11-10T17:00:00,ITA,19,Sicilia,38.11569725,13.3623567,1348,195,1543,21289,22832,1201,9928,735,33495,535921
5477,2020-11-10T17:00:00,ITA,9,Toscana,43.76923077,11.25588885,1582,242,1824,44490,46314,2223,19451,1648,67413,813816
5478,2020-11-10T17:00:00,ITA,10,Umbria,43.10675841,12.38824698,363,66,429,9711,10140,485,5392,206,15738,192401
5479,2020-11-10T17:00:00,ITA,2,Valle d'Aosta,45.73750286,7.320149366,161,15,176,2123,2299,127,1946,218,4463,27907
5480,2020-11-10T17:00:00,ITA,5,Veneto,45.43490485,12.33845213,1596,204,1800,48450,50250,2763,31362,2643,84255,962389
5481,2020-11-11T17:00:00,ITA,13,Abruzzo,42.35122196,13.39843823,546,51,597,10353,10950,662,4956,644,16550,199985
5482,2020-11-11T17:00:00,ITA,17,Basilicata,40.63947052,15.80514834,133,19,152,2996,3148,168,830,69,4047,118262
5483,2020-11-11T17:00:00,ITA,18,Calabria,38.90597598,16.59440194,286,18,304,5833,6137,376,2400,156,8693,304484
5484,2020-11-11T17:00:00,ITA,15,Campania,40.83956555,14.25084984,2077,181,2258,74412,76670,3166,18355,896,95921,815377
5485,2020-11-11T17:00:00,ITA,8,Emilia-Romagna,44.49436681,11.3417208,2072,222,2294,41597,43891,2428,29516,4876,78283,939211
5486,2020-11-11T17:00:00,ITA,6,Friuli Venezia Giulia,45.6494354,13.76813649,346,46,392,7773,8165,572,7448,489,16102,246668
5487,2020-11-11T17:00:00,ITA,12,Lazio,41.89277044,12.48366722,2913,255,3168,54415,57583,2479,13968,1503,73054,1403357
5488,2020-11-11T17:00:00,ITA,7,Liguria,44.41149315,8.9326992,1315,98,1413,12542,13955,1102,23278,2009,39242,256277
5489,2020-11-11T17:00:00,ITA,3,Lombardia,45.46679409,9.190347404,6907,764,7671,134247,141918,8180,124025,18723,284666,2066395
5490,2020-11-11T17:00:00,ITA,11,Marche,43.61675973,13.5188753,536,74,610,10904,11514,701,7665,1077,20256,207157
5491,2020-11-11T17:00:00,ITA,14,Molise,41.55774754,14.65916051,48,8,56,1700,1756,71,840,57,2653,67422
5492,2020-11-11T17:00:00,ITA,21,P.A. Bolzano,46.49933453,11.35662422,427,37,464,8421,8885,386,5226,359,14470,133275
5493,2020-11-11T17:00:00,ITA,22,P.A. Trento,46.06893511,11.12123097,307,31,338,2449,2787,253,8367,485,11639,119756
5494,2020-11-11T17:00:00,ITA,1,Piemonte,45.0732745,7.680687483,4790,340,5130,55224,60354,2953,42087,4826,107267,755259
5495,2020-11-11T17:00:00,ITA,16,Puglia,41.12559576,16.86736689,1131,142,1273,18826,20099,1332,8013,896,29008,448063
5496,2020-11-11T17:00:00,ITA,20,Sardegna,39.21531192,9.110616306,418,54,472,8709,9181,416,4019,293,13493,257715
5497,2020-11-11T17:00:00,ITA,19,Sicilia,38.11569725,13.3623567,1376,202,1578,21986,23564,1487,10656,762,34982,541877
5498,2020-11-11T17:00:00,ITA,9,Toscana,43.76923077,11.25588885,1628,246,1874,46026,47900,2507,20319,1701,69920,822966
5499,2020-11-11T17:00:00,ITA,10,Umbria,43.10675841,12.38824698,359,68,427,9907,10334,515,5701,218,16253,194467
5500,2020-11-11T17:00:00,ITA,2,Valle d'Aosta,45.73750286,7.320149366,160,17,177,2155,2332,125,2031,225,4588,28237
5501,2020-11-11T17:00:00,ITA,5,Veneto,45.43490485,12.33845213,1669,208,1877,50358,52235,3082,32413,2689,87337,965761
5502,2020-11-12T17:00:00,ITA,13,Abruzzo,42.35122196,13.39843823,547,52,599,10817,11416,541,5029,646,17091,200964
5503,2020-11-12T17:00:00,ITA,17,Basilicata,40.63947052,15.80514834,134,19,153,3187,3340,202,837,72,4249,119885
5504,2020-11-12T17:00:00,ITA,18,Calabria,38.90597598,16.59440194,298,21,319,6241,6560,426,2402,157,9119,307797
5505,2020-11-12T17:00:00,ITA,15,Campania,40.83956555,14.25084984,1944,192,2136,77923,80059,4065,19000,927,99986,834920
5506,2020-11-12T17:00:00,ITA,8,Emilia-Romagna,44.49436681,11.3417208,2094,228,2322,43702,46024,2402,29735,4925,80684,947920
5507,2020-11-12T17:00:00,ITA,6,Friuli Venezia Giulia,45.6494354,13.76813649,346,47,393,8254,8647,838,7795,498,16940,248809
5508,2020-11-12T17:00:00,ITA,12,Lazio,41.89277044,12.48366722,2953,259,3212,56707,59919,2686,14269,1552,75740,1425173
5509,2020-11-12T17:00:00,ITA,7,Liguria,44.41149315,8.9326992,1363,109,1472,13189,14661,1013,23554,2040,40255,258621
5510,2020-11-12T17:00:00,ITA,3,Lombardia,45.46679409,9.190347404,7047,782,7829,134964,142793,9291,132254,18910,293957,2086645
5511,2020-11-12T17:00:00,ITA,11,Marche,43.61675973,13.5188753,536,74,610,11602,12212,834,7795,1083,21090,209704
5512,2020-11-12T17:00:00,ITA,14,Molise,41.55774754,14.65916051,55,7,62,1762,1824,73,841,61,2726,68089
5513,2020-11-12T17:00:00,ITA,21,P.A. Bolzano,46.49933453,11.35662422,448,42,490,8745,9235,694,5564,365,15164,134708
5514,2020-11-12T17:00:00,ITA,22,P.A. Trento,46.06893511,11.12123097,338,30,368,2465,2833,253,8566,493,11892,120443
5515,2020-11-12T17:00:00,ITA,1,Piemonte,45.0732745,7.680687483,4833,348,5181,58017,63198,4787,43953,4903,112054,770475
5516,2020-11-12T17:00:00,ITA,16,Puglia,41.12559576,16.86736689,1193,145,1338,19917,21255,1434,8252,935,30442,453311
5517,2020-11-12T17:00:00,ITA,20,Sardegna,39.21531192,9.110616306,424,56,480,8891,9371,301,4125,298,13794,260989
5518,2020-11-12T17:00:00,ITA,19,Sicilia,38.11569725,13.3623567,1391,205,1596,23318,24914,1692,10958,802,36674,548214
5519,2020-11-12T17:00:00,ITA,9,Toscana,43.76923077,11.25588885,1653,256,1909,47007,48916,1932,21198,1738,71852,830926
5520,2020-11-12T17:00:00,ITA,10,Umbria,43.10675841,12.38824698,354,69,423,10361,10784,783,6026,226,17036,197139
5521,2020-11-12T17:00:00,ITA,2,Valle d'Aosta,45.73750286,7.320149366,159,16,175,2163,2338,167,2186,231,4755,28810
5522,2020-11-12T17:00:00,ITA,5,Veneto,45.43490485,12.33845213,1763,213,1976,52779,54755,3564,33419,2727,90901,971907
5523,2020-11-13T17:00:00,ITA,13,Abruzzo,42.35122196,13.39843823,567,57,624,11284,11908,683,5205,661,17774,203208
5524,2020-11-13T17:00:00,ITA,17,Basilicata,40.63947052,15.80514834,141,23,164,3436,3600,307,883,73,4556,122141
5525,2020-11-13T17:00:00,ITA,18,Calabria,38.90597598,16.59440194,338,27,365,6312,6677,297,2575,164,9416,310710
5526,2020-11-13T17:00:00,ITA,15,Campania,40.83956555,14.25084984,2153,183,2336,80884,83220,4079,19878,967,104065,854598
5527,2020-11-13T17:00:00,ITA,8,Emilia-Romagna,44.49436681,11.3417208,2164,225,2389,45767,48156,2384,29947,4965,83068,956466
5528,2020-11-13T17:00:00,ITA,6,Friuli Venezia Giulia,45.6494354,13.76813649,366,47,413,8738,9151,831,8114,506,17771,250805
5529,2020-11-13T17:00:00,ITA,12,Lazio,41.89277044,12.48366722,3018,260,3278,59121,62399,2925,14680,1586,78665,1446989
5530,2020-11-13T17:00:00,ITA,7,Liguria,44.41149315,8.9326992,1372,110,1482,13403,14885,1209,24521,2058,41464,261534
5531,2020-11-13T17:00:00,ITA,3,Lombardia,45.46679409,9.190347404,7319,801,8120,143149,151269,10634,134294,19028,304591,2115026
5532,2020-11-13T17:00:00,ITA,11,Marche,43.61675973,13.5188753,559,74,633,12201,12834,740,7902,1094,21830,211777
5533,2020-11-13T17:00:00,ITA,14,Molise,41.55774754,14.65916051,55,7,62,1817,1879,63,848,62,2789,68894
5534,2020-11-13T17:00:00,ITA,21,P.A. Bolzano,46.49933453,11.35662422,453,41,494,9220,9714,820,5896,374,15984,135924
5535,2020-11-13T17:00:00,ITA,22,P.A. Trento,46.06893511,11.12123097,353,30,383,2537,2920,202,8669,505,12094,120800
5536,2020-11-13T17:00:00,ITA,1,Piemonte,45.0732745,7.680687483,4890,353,5243,61411,66654,5258,45694,4964,117312,785558
5537,2020-11-13T17:00:00,ITA,16,Puglia,41.12559576,16.86736689,1249,158,1407,21104,22511,1350,8324,957,31792,459534
5538,2020-11-13T17:00:00,ITA,20,Sardegna,39.21531192,9.110616306,472,57,529,9164,9693,623,4411,313,14417,265279
5539,2020-11-13T17:00:00,ITA,19,Sicilia,38.11569725,13.3623567,1450,210,1660,24626,26286,1707,11258,837,38381,554557
5540,2020-11-13T17:00:00,ITA,9,Toscana,43.76923077,11.25588885,1656,265,1921,48208,50129,2478,22408,1793,74330,839613
5541,2020-11-13T17:00:00,ITA,10,Umbria,43.10675841,12.38824698,359,68,427,9963,10390,604,7016,234,17640,199394
5542,2020-11-13T17:00:00,ITA,2,Valle d'Aosta,45.73750286,7.320149366,149,15,164,2199,2363,103,2261,234,4858,29189
5543,2020-11-13T17:00:00,ITA,5,Veneto,45.43490485,12.33845213,1831,219,2050,55238,57288,3605,34454,2764,94506,978328
5544,2020-11-14T17:00:00,ITA,13,Abruzzo,42.35122196,13.39843823,545,59,604,12018,12622,939,5420,671,18713,205812
5545,2020-11-14T17:00:00,ITA,17,Basilicata,40.63947052,15.80514834,144,21,165,3668,3833,265,910,78,4821,124396
5546,2020-11-14T17:00:00,ITA,18,Calabria,38.90597598,16.59440194,345,26,371,6615,6986,333,2594,169,9749,314068
5547,2020-11-14T17:00:00,ITA,15,Campania,40.83956555,14.25084984,2080,184,2264,82982,85246,3351,21176,994,107416,872094
5548,2020-11-14T17:00:00,ITA,8,Emilia-Romagna,44.49436681,11.3417208,2243,231,2474,48088,50562,2637,30129,5008,85699,965000
5549,2020-11-14T17:00:00,ITA,6,Friuli Venezia Giulia,45.6494354,13.76813649,378,45,423,9106,9529,558,8284,516,18329,252095
5550,2020-11-14T17:00:00,ITA,12,Lazio,41.89277044,12.48366722,3076,273,3349,61609,64958,2997,15079,1625,81662,1471685
5551,2020-11-14T17:00:00,ITA,7,Liguria,44.41149315,8.9326992,1402,108,1510,13824,15334,1091,25133,2088,42555,264030
5552,2020-11-14T17:00:00,ITA,3,Lombardia,45.46679409,9.190347404,7621,817,8438,147841,156279,8129,137255,19186,312720,2135880
5553,2020-11-14T17:00:00,ITA,11,Marche,43.61675973,13.5188753,484,74,558,12861,13419,779,8088,1102,22609,214152
5554,2020-11-14T17:00:00,ITA,14,Molise,41.55774754,14.65916051,55,6,61,1869,1930,121,914,66,2910,69735
5555,2020-11-14T17:00:00,ITA,21,P.A. Bolzano,46.49933453,11.35662422,456,44,500,9559,10059,690,6236,379,16674,137003
5556,2020-11-14T17:00:00,ITA,22,P.A. Trento,46.06893511,11.12123097,355,31,386,2448,2834,206,8950,516,12300,121696
5557,2020-11-14T17:00:00,ITA,1,Piemonte,45.0732745,7.680687483,4902,360,5262,63953,69215,4471,47567,5001,121783,798081
5558,2020-11-14T17:00:00,ITA,16,Puglia,41.12559576,16.86736689,1289,178,1467,22533,24000,1741,8560,973,33533,466554
5559,2020-11-14T17:00:00,ITA,20,Sardegna,39.21531192,9.110616306,506,59,565,9417,9982,396,4513,318,14813,268876
5560,2020-11-14T17:00:00,ITA,19,Sicilia,38.11569725,13.3623567,1462,215,1677,26129,27806,1729,11444,860,40110,560736
5561,2020-11-14T17:00:00,ITA,9,Toscana,43.76923077,11.25588885,1679,266,1945,49116,51061,2420,23854,1835,76750,848164
5562,2020-11-14T17:00:00,ITA,10,Umbria,43.10675841,12.38824698,361,68,429,10347,10776,579,7201,242,18219,201299
5563,2020-11-14T17:00:00,ITA,2,Valle d'Aosta,45.73750286,7.320149366,146,13,159,2140,2299,245,2564,240,5103,29478
5564,2020-11-14T17:00:00,ITA,5,Veneto,45.43490485,12.33845213,1869,228,2097,57608,59705,3578,35563,2816,98084,984607
5565,2020-11-15T17:00:00,ITA,13,Abruzzo,42.35122196,13.39843823,565,59,624,12410,13034,470,5469,679,19182,207477
5566,2020-11-15T17:00:00,ITA,17,Basilicata,40.63947052,15.80514834,155,26,181,3788,3969,158,931,79,4979,125928
5567,2020-11-15T17:00:00,ITA,18,Calabria,38.90597598,16.59440194,342,41,383,6656,7039,344,2880,174,10093,316589
5568,2020-11-15T17:00:00,ITA,15,Campania,40.83956555,14.25084984,2224,194,2418,85839,88257,3771,21901,1029,111187,891617
5569,2020-11-15T17:00:00,ITA,8,Emilia-Romagna,44.49436681,11.3417208,2285,246,2531,50670,53201,2822,30275,5044,88520,972719
5570,2020-11-15T17:00:00,ITA,6,Friuli Venezia Giulia,45.6494354,13.76813649,401,43,444,9483,9927,608,8482,528,18937,253332
5571,2020-11-15T17:00:00,ITA,12,Lazio,41.89277044,12.48366722,3159,274,3433,63876,67309,2612,15319,1646,84274,1490435
5572,2020-11-15T17:00:00,ITA,7,Liguria,44.41149315,8.9326992,1393,115,1508,14230,15738,822,25530,2109,43377,265754
5573,2020-11-15T17:00:00,ITA,3,Lombardia,45.46679409,9.190347404,7781,837,8618,153923,162541,8060,138872,19367,320780,2152870
5574,2020-11-15T17:00:00,ITA,11,Marche,43.61675973,13.5188753,483,77,560,13489,14049,707,8156,1111,23316,216441
5575,2020-11-15T17:00:00,ITA,14,Molise,41.55774754,14.65916051,60,7,67,1945,2012,85,916,67,2995,70623
5576,2020-11-15T17:00:00,ITA,21,P.A. Bolzano,46.49933453,11.35662422,479,43,522,9768,10290,628,6614,398,17302,137933
5577,2020-11-15T17:00:00,ITA,22,P.A. Trento,46.06893511,11.12123097,370,33,403,2559,2962,268,9082,524,12568,122282
5578,2020-11-15T17:00:00,ITA,1,Piemonte,45.0732745,7.680687483,4921,372,5293,65936,71229,3682,49190,5046,125465,806208
5579,2020-11-15T17:00:00,ITA,16,Puglia,41.12559576,16.86736689,1261,180,1441,23261,24702,905,8751,985,34438,469846
5580,2020-11-15T17:00:00,ITA,20,Sardegna,39.21531192,9.110616306,510,60,570,9650,10220,370,4641,322,15183,271440
5581,2020-11-15T17:00:00,ITA,19,Sicilia,38.11569725,13.3623567,1476,217,1693,27114,28807,1422,11829,896,41532,565253
5582,2020-11-15T17:00:00,ITA,9,Toscana,43.76923077,11.25588885,1734,274,2008,50300,52308,2653,25216,1879,79403,856660
5583,2020-11-15T17:00:00,ITA,10,Umbria,43.10675841,12.38824698,366,71,437,10658,11095,657,7528,253,18876,203439
5584,2020-11-15T17:00:00,ITA,2,Valle d'Aosta,45.73750286,7.320149366,148,12,160,2135,2295,143,2703,248,5246,29683
5585,2020-11-15T17:00:00,ITA,5,Veneto,45.43490485,12.33845213,1934,241,2175,59331,61506,2792,36525,2845,100876,989643
5586,2020-11-16T17:00:00,ITA,13,Abruzzo,42.35122196,13.39843823,571,59,630,12869,13499,642,5634,690,19823,209407
5587,2020-11-16T17:00:00,ITA,17,Basilicata,40.63947052,15.80514834,140,27,167,3905,4072,127,949,85,5106,126804
5588,2020-11-16T17:00:00,ITA,18,Calabria,38.90597598,16.59440194,358,45,403,6865,7268,297,2942,180,10390,318237
5589,2020-11-16T17:00:00,ITA,15,Campania,40.83956555,14.25084984,2190,192,2382,89132,91514,4079,22686,1066,115266,912270
5590,2020-11-16T17:00:00,ITA,8,Emilia-Romagna,44.49436681,11.3417208,2393,247,2640,52789,55429,2547,30570,5067,91066,980006
5591,2020-11-16T17:00:00,ITA,6,Friuli Venezia Giulia,45.6494354,13.76813649,407,47,454,9601,10055,456,8792,546,19393,254630
5592,2020-11-16T17:00:00,ITA,12,Lazio,41.89277044,12.48366722,3099,278,3377,65893,69270,2407,15731,1680,86681,1503973
5593,2020-11-16T17:00:00,ITA,7,Liguria,44.41149315,8.9326992,1381,111,1492,14409,15901,365,25717,2124,43742,266634
5594,2020-11-16T17:00:00,ITA,3,Lombardia,45.46679409,9.190347404,7901,855,8756,143583,152339,4128,153103,19466,324908,2160155
5595,2020-11-16T17:00:00,ITA,11,Marche,43.61675973,13.5188753,499,78,577,13634,14211,282,8268,1119,23598,217369
5596,2020-11-16T17:00:00,ITA,14,Molise,41.55774754,14.65916051,56,7,63,2019,2082,126,968,71,3121,71476
5597,2020-11-16T17:00:00,ITA,21,P.A. Bolzano,46.49933453,11.35662422,487,43,530,10038,10568,544,6873,405,17846,138774
5598,2020-11-16T17:00:00,ITA,22,P.A. Trento,46.06893511,11.12123097,386,32,418,2420,2838,181,9372,539,12749,123110
5599,2020-11-16T17:00:00,ITA,1,Piemonte,45.0732745,7.680687483,5074,378,5452,67488,72940,3476,50884,5117,128941,815862
5600,2020-11-16T17:00:00,ITA,16,Puglia,41.12559576,16.86736689,1295,182,1477,24048,25525,1044,8936,1021,35482,472227
5601,2020-11-16T17:00:00,ITA,20,Sardegna,39.21531192,9.110616306,510,63,573,9881,10454,411,4812,328,15594,273343
5602,2020-11-16T17:00:00,ITA,19,Sicilia,38.11569725,13.3623567,1501,224,1725,28040,29765,1461,12296,932,42993,570817
5603,2020-11-16T17:00:00,ITA,9,Toscana,43.76923077,11.25588885,1777,284,2061,51790,53851,2433,26070,1915,81836,863173
5604,2020-11-16T17:00:00,ITA,10,Umbria,43.10675841,12.38824698,375,72,447,10792,11239,283,7658,262,19159,203887
5605,2020-11-16T17:00:00,ITA,2,Valle d'Aosta,45.73750286,7.320149366,151,16,167,2099,2266,99,2826,253,5345,29915
5606,2020-11-16T17:00:00,ITA,5,Veneto,45.43490485,12.33845213,1985,252,2237,60461,62698,1966,37277,2867,102842,993185
5607,2020-11-17T17:00:00,ITA,13,Abruzzo,42.35122196,13.39843823,590,66,656,13352,14008,729,5841,703,20552,211733
5608,2020-11-17T17:00:00,ITA,17,Basilicata,40.63947052,15.80514834,150,30,180,4146,4326,269,964,85,5375,129135
5609,2020-11-17T17:00:00,ITA,18,Calabria,38.90597598,16.59440194,353,53,406,7332,7738,680,3145,187,11070,320121
5610,2020-11-17T17:00:00,ITA,15,Campania,40.83956555,14.25084984,2236,201,2437,90289,92726,3019,24474,1085,118285,925004
5611,2020-11-17T17:00:00,ITA,8,Emilia-Romagna,44.49436681,11.3417208,2451,247,2698,54570,57268,2219,30902,5115,93285,988202
5612,2020-11-17T17:00:00,ITA,6,Friuli Venezia Giulia,45.6494354,13.76813649,454,44,498,9923,10421,536,8952,556,19929,255770
5613,2020-11-17T17:00:00,ITA,12,Lazio,41.89277044,12.48366722,3066,308,3374,67881,71255,2538,16225,1739,89219,1524981
5614,2020-11-17T17:00:00,ITA,7,Liguria,44.41149315,8.9326992,1393,117,1510,15021,16531,685,25752,2144,44427,268832
5615,2020-11-17T17:00:00,ITA,3,Lombardia,45.46679409,9.190347404,8151,894,9045,147522,156567,8448,157121,19668,333356,2177539
5616,2020-11-17T17:00:00,ITA,11,Marche,43.61675973,13.5188753,525,78,603,13908,14511,357,8314,1130,23955,218598
5617,2020-11-17T17:00:00,ITA,14,Molise,41.55774754,14.65916051,60,9,69,2132,2201,147,995,72,3268,72214
5618,2020-11-17T17:00:00,ITA,21,P.A. Bolzano,46.49933453,11.35662422,482,44,526,10175,10701,258,6989,414,18104,139217
5619,2020-11-17T17:00:00,ITA,22,P.A. Trento,46.06893511,11.12123097,388,35,423,2571,2994,276,9489,542,13025,123724
5620,2020-11-17T17:00:00,ITA,1,Piemonte,45.0732745,7.680687483,5150,384,5534,68252,73786,2606,52571,5190,131547,826436
5621,2020-11-17T17:00:00,ITA,16,Puglia,41.12559576,16.86736689,1316,181,1497,25110,26607,1234,9052,1057,36716,477865
5622,2020-11-17T17:00:00,ITA,20,Sardegna,39.21531192,9.110616306,512,64,576,10208,10784,502,4972,340,16096,276049
5623,2020-11-17T17:00:00,ITA,19,Sicilia,38.11569725,13.3623567,1505,227,1732,29024,30756,1698,12964,971,44691,577818
5624,2020-11-17T17:00:00,ITA,9,Toscana,43.76923077,11.25588885,1792,277,2069,52083,54152,2361,28078,1967,84197,870134
5625,2020-11-17T17:00:00,ITA,10,Umbria,43.10675841,12.38824698,368,70,438,10806,11244,351,7991,275,19510,206060
5626,2020-11-17T17:00:00,ITA,2,Valle d'Aosta,45.73750286,7.320149366,152,17,169,1994,2163,154,3079,257,5499,30178
5627,2020-11-17T17:00:00,ITA,5,Veneto,45.43490485,12.33845213,1980,266,2246,60825,63071,3124,39928,2967,105966,1000577
5628,2020-11-18T17:00:00,ITA,13,Abruzzo,42.35122196,13.39843823,621,65,686,13704,14390,641,6091,712,21193,213814
5629,2020-11-18T17:00:00,ITA,17,Basilicata,40.63947052,15.80514834,144,28,172,4332,4504,237,1009,99,5612,131191
5630,2020-11-18T17:00:00,ITA,18,Calabria,38.90597598,16.59440194,388,46,434,8097,8531,936,3278,197,12006,324783
5631,2020-11-18T17:00:00,ITA,15,Campania,40.83956555,14.25084984,2259,200,2459,92680,95139,3657,25643,1160,121942,944638
5632,2020-11-18T17:00:00,ITA,8,Emilia-Romagna,44.49436681,11.3417208,2449,244,2693,56626,59319,2371,31167,5168,95654,995472
5633,2020-11-18T17:00:00,ITA,6,Friuli Venezia Giulia,45.6494354,13.76813649,470,49,519,10235,10754,796,9404,567,20725,257516
5634,2020-11-18T17:00:00,ITA,12,Lazio,41.89277044,12.48366722,3056,318,3374,70117,73491,2866,16775,1819,92085,1546539
5635,2020-11-18T17:00:00,ITA,7,Liguria,44.41149315,8.9326992,1371,118,1489,15279,16768,775,26271,2163,45202,271234
5636,2020-11-18T17:00:00,ITA,3,Lombardia,45.46679409,9.190347404,8323,903,9226,142857,152083,7633,169056,19850,340989,2193319
5637,2020-11-18T17:00:00,ITA,11,Marche,43.61675973,13.5188753,527,79,606,14147,14753,479,8542,1139,24434,220387
5638,2020-11-18T17:00:00,ITA,14,Molise,41.55774754,14.65916051,58,7,65,2002,2067,98,1219,80,3366,73076
5639,2020-11-18T17:00:00,ITA,21,P.A. Bolzano,46.49933453,11.35662422,481,39,520,10381,10901,581,7359,425,18685,140362
5640,2020-11-18T17:00:00,ITA,22,P.A. Trento,46.06893511,11.12123097,398,38,436,2424,2860,236,9852,549,13261,124544
5641,2020-11-18T17:00:00,ITA,1,Piemonte,45.0732745,7.680687483,5208,388,5596,69468,75064,3281,54511,5253,134828,836881
5642,2020-11-18T17:00:00,ITA,16,Puglia,41.12559576,16.86736689,1320,198,1518,26096,27614,1368,9385,1085,38084,483912
5643,2020-11-18T17:00:00,ITA,20,Sardegna,39.21531192,9.110616306,505,63,568,10477,11045,422,5123,350,16518,278979
5644,2020-11-18T17:00:00,ITA,19,Sicilia,38.11569725,13.3623567,1528,240,1768,30334,32102,1837,13411,1015,46528,582685
5645,2020-11-18T17:00:00,ITA,9,Toscana,43.76923077,11.25588885,1805,282,2087,52023,54110,2508,30573,2022,86705,880609
5646,2020-11-18T17:00:00,ITA,10,Umbria,43.10675841,12.38824698,368,74,442,10832,11274,501,8451,286,20011,208149
5647,2020-11-18T17:00:00,ITA,2,Valle d'Aosta,45.73750286,7.320149366,146,17,163,1930,2093,87,3234,259,5586,30337
5648,2020-11-18T17:00:00,ITA,5,Veneto,45.43490485,12.33845213,2079,274,2353,61953,64306,2972,41613,3019,108938,1005997
5649,2020-11-19T17:00:00,ITA,13,Abruzzo,42.35122196,13.39843823,658,74,732,14130,14862,649,6259,721,21842,215944
5650,2020-11-19T17:00:00,ITA,17,Basilicata,40.63947052,15.80514834,147,28,175,4587,4762,271,1020,101,5883,133335
5651,2020-11-19T17:00:00,ITA,18,Calabria,38.90597598,16.59440194,395,47,442,8536,8978,506,3332,202,12512,327394
5652,2020-11-19T17:00:00,ITA,15,Campania,40.83956555,14.25084984,2287,194,2481,93705,96186,3334,27898,1192,125276,956035
5653,2020-11-19T17:00:00,ITA,8,Emilia-Romagna,44.49436681,11.3417208,2489,244,2733,58276,61009,2160,31587,5218,97814,1003409
5654,2020-11-19T17:00:00,ITA,6,Friuli Venezia Giulia,45.6494354,13.76813649,485,48,533,11112,11645,1197,9697,580,21922,259446
5655,2020-11-19T17:00:00,ITA,12,Lazio,41.89277044,12.48366722,3103,329,3432,72109,75541,2697,17361,1880,94782,1570432
5656,2020-11-19T17:00:00,ITA,7,Liguria,44.41149315,8.9326992,1319,119,1438,15589,17027,792,26789,2178,45994,273332
5657,2020-11-19T17:00:00,ITA,3,Lombardia,45.46679409,9.190347404,8291,915,9206,146374,155580,7453,172847,20015,348442,2208742
5658,2020-11-19T17:00:00,ITA,11,Marche,43.61675973,13.5188753,526,78,604,14252,14856,667,9095,1150,25101,222600
5659,2020-11-19T17:00:00,ITA,14,Molise,41.55774754,14.65916051,66,8,74,2125,2199,154,1237,84,3520,74113
5660,2020-11-19T17:00:00,ITA,21,P.A. Bolzano,46.49933453,11.35662422,469,39,508,10696,11204,696,7739,438,19381,141552
5661,2020-11-19T17:00:00,ITA,22,P.A. Trento,46.06893511,11.12123097,407,39,446,2540,2986,266,9985,556,13527,125144
5662,2020-11-19T17:00:00,ITA,1,Piemonte,45.0732745,7.680687483,5147,390,5537,71700,77237,5349,57609,5331,140177,865428
5663,2020-11-19T17:00:00,ITA,16,Puglia,41.12559576,16.86736689,1324,200,1524,26976,28500,1263,9734,1113,39347,491204
5664,2020-11-19T17:00:00,ITA,20,Sardegna,39.21531192,9.110616306,517,67,584,10808,11392,479,5243,362,16997,283137
5665,2020-11-19T17:00:00,ITA,19,Sicilia,38.11569725,13.3623567,1532,240,1772,31809,33581,1871,13763,1055,48399,590160
5666,2020-11-19T17:00:00,ITA,9,Toscana,43.76923077,11.25588885,1814,287,2101,52023,54124,1972,32480,2073,88677,888853
5667,2020-11-19T17:00:00,ITA,10,Umbria,43.10675841,12.38824698,369,75,444,10941,11385,556,8889,293,20567,210121
5668,2020-11-19T17:00:00,ITA,2,Valle d'Aosta,45.73750286,7.320149366,144,12,156,1879,2035,91,3371,271,5677,30688
5669,2020-11-19T17:00:00,ITA,5,Veneto,45.43490485,12.33845213,2121,279,2400,64182,66582,3753,43052,3057,112691,1011752
5670,2020-11-20T17:00:00,ITA,13,Abruzzo,42.35122196,13.39843823,661,75,736,14642,15378,705,6430,739,22547,218064
5671,2020-11-20T17:00:00,ITA,17,Basilicata,40.63947052,15.80514834,154,27,181,4762,4943,219,1055,104,6102,135426
5672,2020-11-20T17:00:00,ITA,18,Calabria,38.90597598,16.59440194,415,46,461,8906,9367,515,3447,213,13027,330399
5673,2020-11-20T17:00:00,ITA,15,Campania,40.83956555,14.25084984,2244,201,2445,96547,98992,4226,29293,1217,129502,972976
5674,2020-11-20T17:00:00,ITA,8,Emilia-Romagna,44.49436681,11.3417208,2534,244,2778,60156,62934,2533,32145,5265,100344,1011858
5675,2020-11-20T17:00:00,ITA,6,Friuli Venezia Giulia,45.6494354,13.76813649,505,54,559,11616,12175,1018,10157,608,22940,261532
5676,2020-11-20T17:00:00,ITA,12,Lazio,41.89277044,12.48366722,3202,337,3539,74207,77746,2667,17782,1921,97449,1592354
5677,2020-11-20T17:00:00,ITA,7,Liguria,44.41149315,8.9326992,1290,120,1410,14544,15954,761,28594,2207,46755,275463
5678,2020-11-20T17:00:00,ITA,3,Lombardia,45.46679409,9.190347404,8304,930,9234,150407,159641,9221,177832,20190,357663,2221955
5679,2020-11-20T17:00:00,ITA,11,Marche,43.61675973,13.5188753,542,81,623,14354,14977,512,9475,1161,25613,224325
5680,2020-11-20T17:00:00,ITA,14,Molise,41.55774754,14.65916051,52,8,60,2111,2171,139,1402,86,3659,75410
5681,2020-11-20T17:00:00,ITA,21,P.A. Bolzano,46.49933453,11.35662422,468,38,506,11005,11511,736,8160,446,20117,142658
5682,2020-11-20T17:00:00,ITA,22,P.A. Trento,46.06893511,11.12123097,417,38,455,2549,3004,234,10194,563,13761,125701
5683,2020-11-20T17:00:00,ITA,1,Piemonte,45.0732745,7.680687483,5225,393,5618,70927,76545,3861,62074,5419,144038,875229
5684,2020-11-20T17:00:00,ITA,16,Puglia,41.12559576,16.86736689,1408,202,1610,27824,29434,1456,10240,1129,40803,495932
5685,2020-11-20T17:00:00,ITA,20,Sardegna,39.21531192,9.110616306,526,69,595,11049,11644,581,5567,367,17578,286870
5686,2020-11-20T17:00:00,ITA,19,Sicilia,38.11569725,13.3623567,1537,242,1779,32977,34756,1634,14179,1098,50033,596565
5687,2020-11-20T17:00:00,ITA,9,Toscana,43.76923077,11.25588885,1792,295,2087,51782,53869,2207,34894,2121,90884,897193
5688,2020-11-20T17:00:00,ITA,10,Umbria,43.10675841,12.38824698,363,71,434,10934,11368,394,9279,314,20961,211832
5689,2020-11-20T17:00:00,ITA,2,Valle d'Aosta,45.73750286,7.320149366,148,10,158,1922,2080,155,3474,278,5832,30994
5690,2020-11-20T17:00:00,ITA,5,Veneto,45.43490485,12.33845213,2170,267,2437,66250,68687,3468,44349,3123,116159,1016938
5691,2020-11-21T17:00:00,ITA,13,Abruzzo,42.35122196,13.39843823,676,73,749,14848,15597,541,6717,774,23088,219918
5692,2020-11-21T17:00:00,ITA,17,Basilicata,40.63947052,15.80514834,157,24,181,4989,5170,260,1082,110,6362,137110
5693,2020-11-21T17:00:00,ITA,18,Calabria,38.90597598,16.59440194,426,45,471,9317,9788,425,3447,217,13452,333246
5694,2020-11-21T17:00:00,ITA,15,Campania,40.83956555,14.25084984,2260,198,2458,98677,101135,3554,30672,1249,133056,985270
5695,2020-11-21T17:00:00,ITA,8,Emilia-Romagna,44.49436681,11.3417208,2594,241,2835,62245,65080,2723,32672,5312,103064,1019829
5696,2020-11-21T17:00:00,ITA,6,Friuli Venezia Giulia,45.6494354,13.76813649,509,55,564,12193,12757,1043,10593,633,23983,263440
5697,2020-11-21T17:00:00,ITA,12,Lazio,41.89277044,12.48366722,3257,337,3594,76282,79876,2658,18273,1958,100107,1617550
5698,2020-11-21T17:00:00,ITA,7,Liguria,44.41149315,8.9326992,1241,119,1360,14513,15873,761,29416,2227,47516,277654
5699,2020-11-21T17:00:00,ITA,3,Lombardia,45.46679409,9.190347404,8314,936,9250,153435,162685,8853,183472,20359,366516,2236696
5700,2020-11-21T17:00:00,ITA,11,Marche,43.61675973,13.5188753,544,86,630,14492,15122,452,9775,1168,26065,225892
5701,2020-11-21T17:00:00,ITA,14,Molise,41.55774754,14.65916051,51,9,60,2248,2308,157,1416,92,3816,76461
5702,2020-11-21T17:00:00,ITA,21,P.A. Bolzano,46.49933453,11.35662422,450,39,489,11186,11675,548,8528,462,20665,143675
5703,2020-11-21T17:00:00,ITA,22,P.A. Trento,46.06893511,11.12123097,413,40,453,2249,2702,212,10694,577,13973,127347
5704,2020-11-21T17:00:00,ITA,1,Piemonte,45.0732745,7.680687483,5150,390,5540,70552,76092,2896,65346,5496,146934,890725
5705,2020-11-21T17:00:00,ITA,16,Puglia,41.12559576,16.86736689,1432,197,1629,28791,30420,1377,10612,1148,42180,501346
5706,2020-11-21T17:00:00,ITA,20,Sardegna,39.21531192,9.110616306,504,70,574,11340,11914,511,5796,379,18089,289864
5707,2020-11-21T17:00:00,ITA,19,Sicilia,38.11569725,13.3623567,1568,242,1810,34431,36241,1838,14489,1141,51871,602679
5708,2020-11-21T17:00:00,ITA,9,Toscana,43.76923077,11.25588885,1798,296,2094,51046,53140,1892,37471,2165,92776,904959
5709,2020-11-21T17:00:00,ITA,10,Umbria,43.10675841,12.38824698,370,75,445,10978,11423,408,9623,323,21369,213635
5710,2020-11-21T17:00:00,ITA,2,Valle d'Aosta,45.73750286,7.320149366,149,11,160,1841,2001,91,3641,281,5923,31251
5711,2020-11-21T17:00:00,ITA,5,Veneto,45.43490485,12.33845213,2200,275,2475,68272,70747,3567,45789,3190,119726,1022442
5712,2020-11-22T17:00:00,ITA,13,Abruzzo,42.35122196,13.39843823,664,72,736,15395,16131,560,6731,786,23648,221913
5713,2020-11-22T17:00:00,ITA,17,Basilicata,40.63947052,15.80514834,156,23,179,5153,5332,208,1128,110,6570,138861
5714,2020-11-22T17:00:00,ITA,18,Calabria,38.90597598,16.59440194,433,47,480,9578,10058,444,3616,222,13896,335526
5715,2020-11-22T17:00:00,ITA,15,Campania,40.83956555,14.25084984,2218,201,2419,101062,103481,3217,31522,1270,136273,1002964
5716,2020-11-22T17:00:00,ITA,8,Emilia-Romagna,44.49436681,11.3417208,2666,249,2915,64359,67274,2665,33105,5350,105729,1027297
5717,2020-11-22T17:00:00,ITA,6,Friuli Venezia Giulia,45.6494354,13.76813649,545,56,601,12450,13051,675,10961,646,24658,264942
5718,2020-11-22T17:00:00,ITA,12,Lazio,41.89277044,12.48366722,3298,339,3637,78416,82053,2533,18609,1978,102640,1636960
5719,2020-11-22T17:00:00,ITA,7,Liguria,44.41149315,8.9326992,1253,122,1375,14503,15878,611,30008,2241,48127,279225
5720,2020-11-22T17:00:00,ITA,3,Lombardia,45.46679409,9.190347404,8391,949,9340,155066,164406,5094,186680,20524,371610,2248813
5721,2020-11-22T17:00:00,ITA,11,Marche,43.61675973,13.5188753,542,88,630,14737,15367,529,10047,1180,26594,227685
5722,2020-11-22T17:00:00,ITA,14,Molise,41.55774754,14.65916051,51,11,62,2308,2370,93,1445,94,3909,77476
5723,2020-11-22T17:00:00,ITA,21,P.A. Bolzano,46.49933453,11.35662422,453,38,491,11133,11624,535,9107,469,21200,144616
5724,2020-11-22T17:00:00,ITA,22,P.A. Trento,46.06893511,11.12123097,420,41,461,2081,2542,159,11012,578,14132,128250
5725,2020-11-22T17:00:00,ITA,1,Piemonte,45.0732745,7.680687483,5132,398,5530,71482,77012,2641,66998,5565,149575,898135
5726,2020-11-22T17:00:00,ITA,16,Puglia,41.12559576,16.86736689,1449,188,1637,29715,31352,1327,10975,1180,43507,506049
5727,2020-11-22T17:00:00,ITA,20,Sardegna,39.21531192,9.110616306,503,70,573,11610,12183,404,5921,389,18493,293328
5728,2020-11-22T17:00:00,ITA,19,Sicilia,38.11569725,13.3623567,1597,241,1838,35324,37162,1258,14781,1186,53129,606566
5729,2020-11-22T17:00:00,ITA,9,Toscana,43.76923077,11.25588885,1785,298,2083,50641,52724,1929,39765,2216,94705,912549
5730,2020-11-22T17:00:00,ITA,10,Umbria,43.10675841,12.38824698,368,75,443,11129,11572,400,9864,333,21769,215754
5731,2020-11-22T17:00:00,ITA,2,Valle d'Aosta,45.73750286,7.320149366,144,14,158,1761,1919,99,3818,285,6022,31620
5732,2020-11-22T17:00:00,ITA,5,Veneto,45.43490485,12.33845213,2211,281,2492,69964,72456,2956,47005,3221,122682,1027321
5733,2020-11-23T17:00:00,ITA,13,Abruzzo,42.35122196,13.39843823,672,71,743,15606,16349,640,7135,804,24288,223871
5734,2020-11-23T17:00:00,ITA,17,Basilicata,40.63947052,15.80514834,157,23,180,5192,5372,58,1142,114,6628,139045
5735,2020-11-23T17:00:00,ITA,18,Calabria,38.90597598,16.59440194,435,47,482,9664,10146,321,3832,239,14217,337422
5736,2020-11-23T17:00:00,ITA,15,Campania,40.83956555,14.25084984,2331,201,2532,100977,103509,2158,33613,1309,138431,1009443
5737,2020-11-23T17:00:00,ITA,8,Emilia-Romagna,44.49436681,11.3417208,2738,248,2986,66394,69380,2347,33309,5384,108073,1033714
5738,2020-11-23T17:00:00,ITA,6,Friuli Venezia Giulia,45.6494354,13.76813649,565,55,620,12585,13205,377,11157,673,25035,265792
5739,2020-11-23T17:00:00,ITA,12,Lazio,41.89277044,12.48366722,3351,335,3686,80203,83889,2341,19066,2026,104981,1653284
5740,2020-11-23T17:00:00,ITA,7,Liguria,44.41149315,8.9326992,1248,122,1370,13951,15321,285,30830,2261,48412,280174
5741,2020-11-23T17:00:00,ITA,3,Lombardia,45.46679409,9.190347404,8331,945,9276,140642,149918,5289,206317,20664,376899,2262985
5742,2020-11-23T17:00:00,ITA,11,Marche,43.61675973,13.5188753,550,90,640,14822,15462,161,10105,1188,26755,228318
5743,2020-11-23T17:00:00,ITA,14,Molise,41.55774754,14.65916051,57,10,67,2341,2408,91,1497,95,4000,78437
5744,2020-11-23T17:00:00,ITA,21,P.A. Bolzano,46.49933453,11.35662422,473,38,511,11104,11615,260,9371,474,21460,145053
5745,2020-11-23T17:00:00,ITA,22,P.A. Trento,46.06893511,11.12123097,433,43,476,2042,2518,93,11122,585,14225,128773
5746,2020-11-23T17:00:00,ITA,1,Piemonte,45.0732745,7.680687483,5112,399,5511,71412,76923,1730,68736,5646,151305,907022
5747,2020-11-23T17:00:00,ITA,16,Puglia,41.12559576,16.86736689,1499,191,1690,30289,31979,980,11288,1220,44487,507599
5748,2020-11-23T17:00:00,ITA,20,Sardegna,39.21531192,9.110616306,512,72,584,11880,12464,505,6139,395,18998,295290
5749,2020-11-23T17:00:00,ITA,19,Sicilia,38.11569725,13.3623567,1604,243,1847,36066,37913,1249,15238,1227,54378,611550
5750,2020-11-23T17:00:00,ITA,9,Toscana,43.76923077,11.25588885,1832,296,2128,50291,52419,1323,41345,2264,96028,917080
5751,2020-11-23T17:00:00,ITA,10,Umbria,43.10675841,12.38824698,371,78,449,10034,10483,105,11054,337,21874,215945
5752,2020-11-23T17:00:00,ITA,2,Valle d'Aosta,45.73750286,7.320149366,146,13,159,1690,1849,77,3960,290,6099,31934
5753,2020-11-23T17:00:00,ITA,5,Veneto,45.43490485,12.33845213,2280,290,2570,71157,73727,2540,48237,3258,125222,1030974
5754,2020-11-24T17:00:00,ITA,13,Abruzzo,42.35122196,13.39843823,672,71,743,15913,16656,536,7344,822,24822,225989
5755,2020-11-24T17:00:00,ITA,17,Basilicata,40.63947052,15.80514834,160,19,179,5412,5591,261,1168,130,6889,140861
5756,2020-11-24T17:00:00,ITA,18,Calabria,38.90597598,16.59440194,429,42,471,9664,10135,307,4146,243,14524,340065
5757,2020-11-24T17:00:00,ITA,15,Campania,40.83956555,14.25084984,2274,201,2475,100376,102851,1764,35957,1387,140195,1011680
5758,2020-11-24T17:00:00,ITA,8,Emilia-Romagna,44.49436681,11.3417208,2723,243,2966,68378,71344,2501,33788,5439,110571,1041385
5759,2020-11-24T17:00:00,ITA,6,Friuli Venezia Giulia,45.6494354,13.76813649,561,54,615,12732,13347,554,11543,699,25589,267036
5760,2020-11-24T17:00:00,ITA,12,Lazio,41.89277044,12.48366722,3361,345,3706,82090,85796,2509,19606,2088,107490,1679178
5761,2020-11-24T17:00:00,ITA,7,Liguria,44.41149315,8.9326992,1179,121,1300,13483,14783,509,31852,2286,48921,281926
5762,2020-11-24T17:00:00,ITA,3,Lombardia,45.46679409,9.190347404,8360,932,9292,139468,148760,4886,212175,20850,381785,2274365
5763,2020-11-24T17:00:00,ITA,11,Marche,43.61675973,13.5188753,555,89,644,15073,15717,351,10188,1201,27106,229538
5764,2020-11-24T17:00:00,ITA,14,Molise,41.55774754,14.65916051,61,10,71,2388,2459,71,1516,96,4071,79053
5765,2020-11-24T17:00:00,ITA,21,P.A. Bolzano,46.49933453,11.35662422,459,40,499,11157,11656,160,9474,490,21620,145395
5766,2020-11-24T17:00:00,ITA,22,P.A. Trento,46.06893511,11.12123097,436,42,478,1994,2472,143,11297,599,14368,129600
5767,2020-11-24T17:00:00,ITA,1,Piemonte,45.0732745,7.680687483,5116,404,5520,71555,77075,2070,70581,5719,153375,915304
5768,2020-11-24T17:00:00,ITA,16,Puglia,41.12559576,16.86736689,1485,205,1690,31269,32959,1567,11823,1272,46054,515378
5769,2020-11-24T17:00:00,ITA,20,Sardegna,39.21531192,9.110616306,527,73,600,11962,12562,290,6319,407,19288,297167
5770,2020-11-24T17:00:00,ITA,19,Sicilia,38.11569725,13.3623567,1601,243,1844,36355,38199,1306,16210,1275,55684,617938
5771,2020-11-24T17:00:00,ITA,9,Toscana,43.76923077,11.25588885,1771,296,2067,48639,50706,962,43973,2311,96990,922166
5772,2020-11-24T17:00:00,ITA,10,Umbria,43.10675841,12.38824698,368,72,440,9757,10197,218,11548,347,22092,217537
5773,2020-11-24T17:00:00,ITA,2,Valle d'Aosta,45.73750286,7.320149366,143,14,157,1610,1767,73,4113,292,6172,32193
5774,2020-11-24T17:00:00,ITA,5,Veneto,45.43490485,12.33845213,2336,300,2636,70718,73354,2194,50709,3353,127416,1035198
5775,2020-11-25T17:00:00,ITA,13,Abruzzo,42.35122196,13.39843823,676,72,748,16284,17032,623,7582,831,25445,228016
5776,2020-11-25T17:00:00,ITA,17,Basilicata,40.63947052,15.80514834,154,22,176,5691,5867,329,1218,133,7218,143446
5777,2020-11-25T17:00:00,ITA,18,Calabria,38.90597598,16.59440194,425,43,468,9796,10264,335,4345,250,14859,342655
5778,2020-11-25T17:00:00,ITA,15,Campania,40.83956555,14.25084984,2282,192,2474,99674,102148,2815,39428,1434,143010,1028617
5779,2020-11-25T17:00:00,ITA,8,Emilia-Romagna,44.49436681,11.3417208,2763,249,3012,69514,72526,2130,34681,5493,112700,1048727
5780,2020-11-25T17:00:00,ITA,6,Friuli Venezia Giulia,45.6494354,13.76813649,588,54,642,12894,13536,696,12034,715,26285,268850
5781,2020-11-25T17:00:00,ITA,12,Lazio,41.89277044,12.48366722,3348,349,3697,82868,86565,2102,20881,2146,109592,1703897
5782,2020-11-25T17:00:00,ITA,7,Liguria,44.41149315,8.9326992,1115,123,1238,12817,14055,460,33018,2308,49381,283560
5783,2020-11-25T17:00:00,ITA,3,Lombardia,45.46679409,9.190347404,8114,942,9056,128973,138029,5173,227924,21005,386958,2289221
5784,2020-11-25T17:00:00,ITA,11,Marche,43.61675973,13.5188753,578,94,672,15359,16031,448,10312,1211,27554,231259
5785,2020-11-25T17:00:00,ITA,14,Molise,41.55774754,14.65916051,66,10,76,2474,2550,106,1528,99,4177,80516
5786,2020-11-25T17:00:00,ITA,21,P.A. Bolzano,46.49933453,11.35662422,442,41,483,11117,11600,341,9863,498,21961,146006
5787,2020-11-25T17:00:00,ITA,22,P.A. Trento,46.06893511,11.12123097,421,41,462,1985,2447,179,11494,606,14547,130165
5788,2020-11-25T17:00:00,ITA,1,Piemonte,45.0732745,7.680687483,5095,403,5498,72423,77921,2878,72529,5803,156253,923880
5789,2020-11-25T17:00:00,ITA,16,Puglia,41.12559576,16.86736689,1483,210,1693,32378,34071,1511,12192,1302,47565,518776
5790,2020-11-25T17:00:00,ITA,20,Sardegna,39.21531192,9.110616306,515,76,591,12106,12697,351,6529,413,19639,300076
5791,2020-11-25T17:00:00,ITA,19,Sicilia,38.11569725,13.3623567,1574,250,1824,36496,38320,1317,17359,1322,57001,625213
5792,2020-11-25T17:00:00,ITA,9,Toscana,43.76923077,11.25588885,1754,286,2040,47240,49280,986,46318,2378,97976,928848
5793,2020-11-25T17:00:00,ITA,10,Umbria,43.10675841,12.38824698,361,70,431,9506,9937,386,12186,355,22478,219242
5794,2020-11-25T17:00:00,ITA,2,Valle d'Aosta,45.73750286,7.320149366,137,16,153,1530,1683,27,4219,297,6199,32389
5795,2020-11-25T17:00:00,ITA,5,Veneto,45.43490485,12.33845213,2422,305,2727,72411,75138,2660,51509,3429,130076,1039770
5796,2020-11-26T17:00:00,ITA,13,Abruzzo,42.35122196,13.39843823,694,74,768,16566,17334,570,7830,851,26015,229937
5797,2020-11-26T17:00:00,ITA,17,Basilicata,40.63947052,15.80514834,156,22,178,5922,6100,236,1218,136,7454,145411
5798,2020-11-26T17:00:00,ITA,18,Calabria,38.90597598,16.59440194,428,45,473,9993,10466,397,4536,254,15256,344984
5799,2020-11-26T17:00:00,ITA,15,Campania,40.83956555,14.25084984,2212,200,2412,100972,103384,3008,41151,1483,146018,1039969
5800,2020-11-26T17:00:00,ITA,8,Emilia-Romagna,44.49436681,11.3417208,2679,258,2937,68535,71472,2157,37835,5548,114855,1055046
5801,2020-11-26T17:00:00,ITA,6,Friuli Venezia Giulia,45.6494354,13.76813649,599,55,654,13168,13822,814,12536,741,27099,270753
5802,2020-11-26T17:00:00,ITA,12,Lazio,41.89277044,12.48366722,3408,352,3760,83543,87303,2260,22334,2215,111852,1726408
5803,2020-11-26T17:00:00,ITA,7,Liguria,44.41149315,8.9326992,1075,114,1189,12303,13492,570,34137,2322,49951,285519
5804,2020-11-26T17:00:00,ITA,3,Lombardia,45.46679409,9.190347404,7996,934,8930,131471,140401,5697,231042,21212,392655,2304509
5805,2020-11-26T17:00:00,ITA,11,Marche,43.61675973,13.5188753,586,90,676,15733,16409,519,10443,1221,28073,233374
5806,2020-11-26T17:00:00,ITA,14,Molise,41.55774754,14.65916051,69,9,78,2574,2652,108,1530,103,4285,81426
5807,2020-11-26T17:00:00,ITA,21,P.A. Bolzano,46.49933453,11.35662422,434,40,474,10976,11450,292,10294,509,22253,146515
5808,2020-11-26T17:00:00,ITA,22,P.A. Trento,46.06893511,11.12123097,417,43,460,1902,2362,297,11867,615,14844,131463
5809,2020-11-26T17:00:00,ITA,1,Piemonte,45.0732745,7.680687483,4992,403,5395,73011,78406,2751,74723,5875,159004,933365
5810,2020-11-26T17:00:00,ITA,16,Puglia,41.12559576,16.86736689,1577,211,1788,33191,34979,1436,12668,1354,49001,524389
5811,2020-11-26T17:00:00,ITA,20,Sardegna,39.21531192,9.110616306,535,73,608,12363,12971,405,6655,418,20044,302707
5812,2020-11-26T17:00:00,ITA,19,Sicilia,38.11569725,13.3623567,1545,253,1798,36710,38508,1768,18890,1371,58769,632415
5813,2020-11-26T17:00:00,ITA,9,Toscana,43.76923077,11.25588885,1712,281,1993,46142,48135,1351,48742,2450,99327,935992
5814,2020-11-26T17:00:00,ITA,10,Umbria,43.10675841,12.38824698,349,68,417,9017,9434,343,13018,369,22821,220882
5815,2020-11-26T17:00:00,ITA,2,Valle d'Aosta,45.73750286,7.320149366,128,17,145,1468,1613,44,4328,302,6243,32671
5816,2020-11-26T17:00:00,ITA,5,Veneto,45.43490485,12.33845213,2447,304,2751,72401,75152,3980,55403,3501,134056,1045655
5817,2020-11-27T17:00:00,ITA,13,Abruzzo,42.35122196,13.39843823,689,74,763,16797,17560,510,8097,868,26525,231706
5818,2020-11-27T17:00:00,ITA,17,Basilicata,40.63947052,15.80514834,153,23,176,5789,5965,218,1559,139,7663,147124
5819,2020-11-27T17:00:00,ITA,18,Calabria,38.90597598,16.59440194,432,44,476,10346,10822,468,4643,259,15724,347932
5820,2020-11-27T17:00:00,ITA,15,Campania,40.83956555,14.25084984,2188,184,2372,101610,103982,2924,43414,1546,148942,1054566
5821,2020-11-27T17:00:00,ITA,8,Emilia-Romagna,44.49436681,11.3417208,2673,250,2923,67366,70289,2165,41116,5614,117019,1061899
5822,2020-11-27T17:00:00,ITA,6,Friuli Venezia Giulia,45.6494354,13.76813649,594,55,649,13606,14255,864,12932,776,27963,272700
5823,2020-11-27T17:00:00,ITA,12,Lazio,41.89277044,12.48366722,3407,355,3762,84172,87934,2276,23910,2284,114128,1743866
5824,2020-11-27T17:00:00,ITA,7,Liguria,44.41149315,8.9326992,1019,109,1128,11883,13011,606,35210,2336,50557,287369
5825,2020-11-27T17:00:00,ITA,3,Lombardia,45.46679409,9.190347404,7869,925,8794,121761,130555,5389,246096,21393,398044,2319630
5826,2020-11-27T17:00:00,ITA,11,Marche,43.61675973,13.5188753,564,91,655,16188,16843,490,10490,1230,28563,235330
5827,2020-11-27T17:00:00,ITA,14,Molise,41.55774754,14.65916051,62,11,73,2552,2625,79,1631,108,4364,82288
5828,2020-11-27T17:00:00,ITA,21,P.A. Bolzano,46.49933453,11.35662422,414,42,456,11027,11483,410,10660,520,22663,147068
5829,2020-11-27T17:00:00,ITA,22,P.A. Trento,46.06893511,11.12123097,408,44,452,1857,2309,229,12141,623,15073,132813
5830,2020-11-27T17:00:00,ITA,1,Piemonte,45.0732745,7.680687483,4922,395,5317,72272,77589,3149,78592,5972,162153,942459
5831,2020-11-27T17:00:00,ITA,16,Puglia,41.12559576,16.86736689,1654,201,1855,34562,36417,1737,12919,1402,50738,529720
5832,2020-11-27T17:00:00,ITA,20,Sardegna,39.21531192,9.110616306,528,71,599,12556,13155,375,6837,427,20419,305590
5833,2020-11-27T17:00:00,ITA,19,Sicilia,38.11569725,13.3623567,1539,250,1789,37294,39083,1566,19834,1418,60335,639257
5834,2020-11-27T17:00:00,ITA,9,Toscana,43.76923077,11.25588885,1647,278,1925,44606,46531,1117,51397,2516,100444,942239
5835,2020-11-27T17:00:00,ITA,10,Umbria,43.10675841,12.38824698,353,62,415,8635,9050,261,13649,383,23082,222157
5836,2020-11-27T17:00:00,ITA,2,Valle d'Aosta,45.73750286,7.320149366,129,15,144,1403,1547,101,4495,302,6344,33067
5837,2020-11-27T17:00:00,ITA,5,Veneto,45.43490485,12.33845213,2440,303,2743,74145,76888,3418,57025,3561,137474,1050631
5838,2020-11-28T17:00:00,ITA,13,Abruzzo,42.35122196,13.39843823,680,77,757,17005,17762,532,8415,879,27056,233698
5839,2020-11-28T17:00:00,ITA,17,Basilicata,40.63947052,15.80514834,142,22,164,5909,6073,215,1663,142,7878,148712
5840,2020-11-28T17:00:00,ITA,18,Calabria,38.90597598,16.59440194,410,42,452,10532,10984,426,4894,272,16150,350706
5841,2020-11-28T17:00:00,ITA,15,Campania,40.83956555,14.25084984,2164,186,2350,102033,104383,2729,45693,1595,151671,1068940
5842,2020-11-28T17:00:00,ITA,8,Emilia-Romagna,44.49436681,11.3417208,2673,245,2918,66865,69783,2172,43717,5684,119184,1068411
5843,2020-11-28T17:00:00,ITA,6,Friuli Venezia Giulia,45.6494354,13.76813649,604,53,657,13339,13996,1432,14598,801,29395,278729
5844,2020-11-28T17:00:00,ITA,12,Lazio,41.89277044,12.48366722,3352,356,3708,85554,89262,2070,24627,2309,116198,1766817
5845,2020-11-28T17:00:00,ITA,7,Liguria,44.41149315,8.9326992,968,117,1085,11640,12725,454,35925,2361,51011,288865
5846,2020-11-28T17:00:00,ITA,3,Lombardia,45.46679409,9.190347404,7616,919,8535,121780,130315,4615,250832,21512,402659,2333345
5847,2020-11-28T17:00:00,ITA,11,Marche,43.61675973,13.5188753,571,85,656,16587,17243,473,10551,1242,29036,236940
5848,2020-11-28T17:00:00,ITA,14,Molise,41.55774754,14.65916051,59,12,71,2526,2597,148,1802,113,4512,83568
5849,2020-11-28T17:00:00,ITA,21,P.A. Bolzano,46.49933453,11.35662422,409,36,445,11113,11558,494,11076,523,23157,147600
5850,2020-11-28T17:00:00,ITA,22,P.A. Trento,46.06893511,11.12123097,404,42,446,1687,2133,219,12530,629,15292,134489
5851,2020-11-28T17:00:00,ITA,1,Piemonte,45.0732745,7.680687483,4781,384,5165,70912,76077,2157,82163,6070,164310,950345
5852,2020-11-28T17:00:00,ITA,16,Puglia,41.12559576,16.86736689,1675,200,1875,35779,37654,1573,13225,1432,52311,536605
5853,2020-11-28T17:00:00,ITA,20,Sardegna,39.21531192,9.110616306,544,73,617,12502,13119,311,7179,432,20730,308816
5854,2020-11-28T17:00:00,ITA,19,Sicilia,38.11569725,13.3623567,1519,247,1766,38116,39882,1189,20181,1461,61524,644441
5855,2020-11-28T17:00:00,ITA,9,Toscana,43.76923077,11.25588885,1593,279,1872,43200,45072,1196,54005,2563,101640,948551
5856,2020-11-28T17:00:00,ITA,10,Umbria,43.10675841,12.38824698,351,64,415,8238,8653,348,14388,389,23430,223404
5857,2020-11-28T17:00:00,ITA,2,Valle d'Aosta,45.73750286,7.320149366,130,14,144,1321,1465,72,4641,310,6416,33335
5858,2020-11-28T17:00:00,ITA,5,Veneto,45.43490485,12.33845213,2654,309,2963,75609,78572,3498,58756,3644,140972,1055933
5859,2020-11-29T17:00:00,ITA,13,Abruzzo,42.35122196,13.39843823,659,75,734,17306,18040,413,8543,886,27469,235487
5860,2020-11-29T17:00:00,ITA,17,Basilicata,40.63947052,15.80514834,141,25,166,6016,6182,172,1723,145,8050,150157
5861,2020-11-29T17:00:00,ITA,18,Calabria,38.90597598,16.59440194,405,43,448,10576,11024,294,5139,281,16444,353026
5862,2020-11-29T17:00:00,ITA,15,Campania,40.83956555,14.25084984,2165,183,2348,102438,104786,2022,47276,1631,153693,1076585
5863,2020-11-29T17:00:00,ITA,8,Emilia-Romagna,44.49436681,11.3417208,2668,245,2913,67316,70229,1850,45089,5714,121032,1074568
5864,2020-11-29T17:00:00,ITA,6,Friuli Venezia Giulia,45.6494354,13.76813649,620,57,677,13632,14309,680,14949,817,30075,280065
5865,2020-11-29T17:00:00,ITA,12,Lazio,41.89277044,12.48366722,3358,355,3713,85999,89712,1993,26151,2328,118191,1784328
5866,2020-11-29T17:00:00,ITA,7,Liguria,44.41149315,8.9326992,970,111,1081,11525,12606,437,36462,2380,51448,290019
5867,2020-11-29T17:00:00,ITA,3,Lombardia,45.46679409,9.190347404,7400,907,8307,124320,132627,3203,251588,21647,405862,2343093
5868,2020-11-29T17:00:00,ITA,11,Marche,43.61675973,13.5188753,598,85,683,17013,17696,518,10603,1255,29554,238861
5869,2020-11-29T17:00:00,ITA,14,Molise,41.55774754,14.65916051,61,13,74,2571,2645,114,1864,117,4626,84436
5870,2020-11-29T17:00:00,ITA,21,P.A. Bolzano,46.49933453,11.35662422,420,36,456,10881,11337,437,11727,530,23594,148650
5871,2020-11-29T17:00:00,ITA,22,P.A. Trento,46.06893511,11.12123097,404,44,448,1871,2319,265,12597,641,15557,135008
5872,2020-11-29T17:00:00,ITA,1,Piemonte,45.0732745,7.680687483,4734,385,5119,71865,76984,2021,83193,6154,166331,956383
5873,2020-11-29T17:00:00,ITA,16,Puglia,41.12559576,16.86736689,1675,212,1887,36357,38244,907,13521,1453,53218,538195
5874,2020-11-29T17:00:00,ITA,20,Sardegna,39.21531192,9.110616306,554,69,623,12776,13399,416,7311,436,21146,310882
5875,2020-11-29T17:00:00,ITA,19,Sicilia,38.11569725,13.3623567,1522,241,1763,38721,40484,1024,20558,1506,62548,649920
5876,2020-11-29T17:00:00,ITA,9,Toscana,43.76923077,11.25588885,1590,278,1868,41676,43544,908,56403,2601,102548,954647
5877,2020-11-29T17:00:00,ITA,10,Umbria,43.10675841,12.38824698,355,65,420,8023,8443,310,14903,394,23740,224573
5878,2020-11-29T17:00:00,ITA,2,Valle d'Aosta,45.73750286,7.320149366,138,13,151,1299,1450,47,4702,311,6463,33672
5879,2020-11-29T17:00:00,ITA,5,Veneto,45.43490485,12.33845213,2442,311,2753,76958,79711,2617,60201,3677,143589,1059827
5880,2020-11-30T17:00:00,ITA,13,Abruzzo,42.35122196,13.39843823,714,76,790,17402,18192,556,8939,893,28024,237280
5881,2020-11-30T17:00:00,ITA,17,Basilicata,40.63947052,15.80514834,150,22,172,6020,6192,92,1797,153,8142,150830
5882,2020-11-30T17:00:00,ITA,18,Calabria,38.90597598,16.59440194,400,42,442,10528,10970,270,5449,295,16714,354571
5883,2020-11-30T17:00:00,ITA,15,Campania,40.83956555,14.25084984,2141,182,2323,102204,104527,1626,49119,1673,155319,1083728
5884,2020-11-30T17:00:00,ITA,8,Emilia-Romagna,44.49436681,11.3417208,2755,249,3004,68730,71734,2041,45586,5753,123073,1079854
5885,2020-11-30T17:00:00,ITA,6,Friuli Venezia Giulia,45.6494354,13.76813649,633,55,688,13827,14515,575,15297,838,30650,281701
5886,2020-11-30T17:00:00,ITA,12,Lazio,41.89277044,12.48366722,3384,350,3734,86467,90201,1589,27212,2367,119780,1799351
5887,2020-11-30T17:00:00,ITA,7,Liguria,44.41149315,8.9326992,997,113,1110,11106,12216,236,37081,2387,51684,290739
5888,2020-11-30T17:00:00,ITA,3,Lombardia,45.46679409,9.190347404,7433,906,8339,117069,125408,1929,260528,21855,407791,2349286
5889,2020-11-30T17:00:00,ITA,11,Marche,43.61675973,13.5188753,585,87,672,17244,17916,252,10626,1264,29806,239816
5890,2020-11-30T17:00:00,ITA,14,Molise,41.55774754,14.65916051,62,14,76,2644,2720,87,1875,118,4713,85198
5891,2020-11-30T17:00:00,ITA,21,P.A. Bolzano,46.49933453,11.35662422,428,37,465,10857,11322,183,11924,531,23777,149001
5892,2020-11-30T17:00:00,ITA,22,P.A. Trento,46.06893511,11.12123097,415,44,459,1989,2448,176,12631,654,15733,135274
5893,2020-11-30T17:00:00,ITA,1,Piemonte,45.0732745,7.680687483,4737,388,5125,69818,74943,1185,86334,6239,167516,961035
5894,2020-11-30T17:00:00,ITA,16,Puglia,41.12559576,16.86736689,1692,209,1901,36871,38772,1102,14065,1483,54320,541174
5895,2020-11-30T17:00:00,ITA,20,Sardegna,39.21531192,9.110616306,580,70,650,12878,13528,329,7503,444,21475,313019
5896,2020-11-30T17:00:00,ITA,19,Sicilia,38.11569725,13.3623567,1547,226,1773,38851,40624,1138,21507,1555,63686,654885
5897,2020-11-30T17:00:00,ITA,9,Toscana,43.76923077,11.25588885,1584,278,1862,40164,42026,893,58774,2641,103441,958389
5898,2020-11-30T17:00:00,ITA,10,Umbria,43.10675841,12.38824698,366,65,431,7804,8235,68,15166,407,23808,224790
5899,2020-11-30T17:00:00,ITA,2,Valle d'Aosta,45.73750286,7.320149366,124,11,135,1182,1317,47,4878,315,6510,33903
5900,2020-11-30T17:00:00,ITA,5,Veneto,45.43490485,12.33845213,2460,320,2780,77885,80665,2003,61216,3711,145592,1062810
5901,2020-12-01T17:00:00,ITA,13,Abruzzo,42.35122196,13.39843823,697,76,773,17415,18188,396,9326,906,28420,238795
5902,2020-12-01T17:00:00,ITA,17,Basilicata,40.63947052,15.80514834,157,21,178,6102,6280,156,1865,153,8298,152306
5903,2020-12-01T17:00:00,ITA,18,Calabria,38.90597598,16.59440194,417,40,457,10512,10969,318,5762,301,17032,356721
5904,2020-12-01T17:00:00,ITA,15,Campania,40.83956555,14.25084984,2099,179,2278,100601,102879,1113,51832,1721,156432,1087947
5905,2020-12-01T17:00:00,ITA,8,Emilia-Romagna,44.49436681,11.3417208,2729,247,2976,68866,71842,1471,46894,5805,124541,1085200
5906,2020-12-01T17:00:00,ITA,6,Friuli Venezia Giulia,45.6494354,13.76813649,637,62,699,13769,14468,736,16055,863,31386,284047
5907,2020-12-01T17:00:00,ITA,12,Lazio,41.89277044,12.48366722,3241,352,3593,87345,90938,1669,28080,2431,121449,1823889
5908,2020-12-01T17:00:00,ITA,7,Liguria,44.41149315,8.9326992,1003,105,1108,11042,12150,339,37469,2404,52023,292065
5909,2020-12-01T17:00:00,ITA,3,Lombardia,45.46679409,9.190347404,7342,876,8218,112815,121033,4048,268702,22104,411839,2361598
5910,2020-12-01T17:00:00,ITA,11,Marche,43.61675973,13.5188753,586,86,672,17532,18204,337,10663,1276,30143,241029
5911,2020-12-01T17:00:00,ITA,14,Molise,41.55774754,14.65916051,64,13,77,2634,2711,60,1942,120,4773,85853
5912,2020-12-01T17:00:00,ITA,21,P.A. Bolzano,46.49933453,11.35662422,414,34,448,10851,11299,94,12038,534,23871,149245
5913,2020-12-01T17:00:00,ITA,22,P.A. Trento,46.06893511,11.12123097,406,44,450,2000,2450,156,12777,662,15889,136084
5914,2020-12-01T17:00:00,ITA,1,Piemonte,45.0732745,7.680687483,4652,377,5029,67240,72269,1617,90561,6303,169133,966274
5915,2020-12-01T17:00:00,ITA,16,Puglia,41.12559576,16.86736689,1693,218,1911,37855,39766,1659,14696,1517,55979,545066
5916,2020-12-01T17:00:00,ITA,20,Sardegna,39.21531192,9.110616306,583,68,651,12975,13626,420,7820,449,21895,315735
5917,2020-12-01T17:00:00,ITA,19,Sicilia,38.11569725,13.3623567,1517,220,1737,38993,40730,1399,22766,1589,65085,661271
5918,2020-12-01T17:00:00,ITA,9,Toscana,43.76923077,11.25588885,1563,267,1830,38371,40201,658,61225,2673,104099,961774
5919,2020-12-01T17:00:00,ITA,10,Umbria,43.10675841,12.38824698,361,64,425,7255,7680,144,15857,415,23952,226025
5920,2020-12-01T17:00:00,ITA,2,Valle d'Aosta,45.73750286,7.320149366,123,13,136,1129,1265,25,4953,317,6535,34026
5921,2020-12-01T17:00:00,ITA,5,Veneto,45.43490485,12.33845213,2527,301,2828,78169,80997,2535,63312,3818,148127,1066796
5922,2020-12-02T17:00:00,ITA,13,Abruzzo,42.35122196,13.39843823,703,74,777,17207,17984,381,9890,927,28801,240318
5923,2020-12-02T17:00:00,ITA,17,Basilicata,40.63947052,15.80514834,158,21,179,6178,6357,157,1945,153,8455,154082
5924,2020-12-02T17:00:00,ITA,18,Calabria,38.90597598,16.59440194,411,36,447,10443,10890,230,6062,310,17262,359679
5925,2020-12-02T17:00:00,ITA,15,Campania,40.83956555,14.25084984,2064,173,2237,100258,102495,1842,54015,1764,158274,1100911
5926,2020-12-02T17:00:00,ITA,8,Emilia-Romagna,44.49436681,11.3417208,2692,247,2939,68366,71305,1569,48931,5874,126110,1091519
5927,2020-12-02T17:00:00,ITA,6,Friuli Venezia Giulia,45.6494354,13.76813649,652,58,710,13983,14693,812,16616,889,32198,286147
5928,2020-12-02T17:00:00,ITA,12,Lazio,41.89277044,12.48366722,3282,350,3632,88272,91904,1791,28860,2476,123240,1843535
5929,2020-12-02T17:00:00,ITA,7,Liguria,44.41149315,8.9326992,963,102,1065,10934,11999,349,37950,2423,52372,293385
5930,2020-12-02T17:00:00,ITA,3,Lombardia,45.46679409,9.190347404,7222,855,8077,110719,118796,3425,274189,22279,415264,2372367
5931,2020-12-02T17:00:00,ITA,11,Marche,43.61675973,13.5188753,565,85,650,17919,18569,421,10706,1289,30564,242628
5932,2020-12-02T17:00:00,ITA,14,Molise,41.55774754,14.65916051,65,9,74,2509,2583,95,2158,127,4868,86650
5933,2020-12-02T17:00:00,ITA,21,P.A. Bolzano,46.49933453,11.35662422,416,33,449,10880,11329,317,12317,542,24188,149819
5934,2020-12-02T17:00:00,ITA,22,P.A. Trento,46.06893511,11.12123097,412,47,459,2000,2459,278,13043,665,16167,137151
5935,2020-12-02T17:00:00,ITA,1,Piemonte,45.0732745,7.680687483,4596,382,4978,65909,70887,1568,93454,6360,170701,971526
5936,2020-12-02T17:00:00,ITA,16,Puglia,41.12559576,16.86736689,1685,204,1889,38871,40760,1668,15341,1546,57647,552400
5937,2020-12-02T17:00:00,ITA,20,Sardegna,39.21531192,9.110616306,577,66,643,13240,13883,445,8004,453,22340,318301
5938,2020-12-02T17:00:00,ITA,19,Sicilia,38.11569725,13.3623567,1494,220,1714,38017,39731,1483,25221,1616,66568,668442
5939,2020-12-02T17:00:00,ITA,9,Toscana,43.76923077,11.25588885,1514,271,1785,35740,37525,776,64632,2718,104875,966235
5940,2020-12-02T17:00:00,ITA,10,Umbria,43.10675841,12.38824698,342,62,404,6679,7083,278,16722,425,24230,227246
5941,2020-12-02T17:00:00,ITA,2,Valle d'Aosta,45.73750286,7.320149366,122,13,135,1071,1206,42,5049,322,6577,34160
5942,2020-12-02T17:00:00,ITA,5,Veneto,45.43490485,12.33845213,2519,308,2827,65965,68792,2782,78230,3887,150909,1070844
5943,2020-12-03T17:00:00,ITA,13,Abruzzo,42.35122196,13.39843823,698,76,774,17054,17828,395,10428,940,29196,241874
5944,2020-12-03T17:00:00,ITA,17,Basilicata,40.63947052,15.80514834,161,20,181,6224,6405,131,2023,158,8586,155787
5945,2020-12-03T17:00:00,ITA,18,Calabria,38.90597598,16.59440194,399,32,431,10160,10591,280,6629,322,17542,362057
5946,2020-12-03T17:00:00,ITA,15,Campania,40.83956555,14.25084984,2041,162,2203,100371,102574,2295,56177,1818,160569,1118787
5947,2020-12-03T17:00:00,ITA,8,Emilia-Romagna,44.49436681,11.3417208,2668,245,2913,67324,70237,1766,51674,5959,127870,1097761
5948,2020-12-03T17:00:00,ITA,6,Friuli Venezia Giulia,45.6494354,13.76813649,629,59,688,14195,14883,772,17146,941,32970,290494
5949,2020-12-03T17:00:00,ITA,12,Lazio,41.89277044,12.48366722,3233,364,3597,89282,92879,1769,29616,2514,125009,1852335
5950,2020-12-03T17:00:00,ITA,7,Liguria,44.41149315,8.9326992,932,102,1034,10424,11458,422,38887,2449,52794,294667
5951,2020-12-03T17:00:00,ITA,3,Lombardia,45.46679409,9.190347404,7025,836,7861,110470,118331,3751,278058,22626,419015,2383936
5952,2020-12-03T17:00:00,ITA,11,Marche,43.61675973,13.5188753,526,88,614,18335,18949,476,10793,1298,31040,244290
5953,2020-12-03T17:00:00,ITA,14,Molise,41.55774754,14.65916051,65,10,75,2357,2432,53,2362,127,4921,87258
5954,2020-12-03T17:00:00,ITA,21,P.A. Bolzano,46.49933453,11.35662422,428,35,463,10752,11215,374,12789,558,24562,150436
5955,2020-12-03T17:00:00,ITA,22,P.A. Trento,46.06893511,11.12123097,404,45,449,2083,2532,239,13200,674,16406,138153
5956,2020-12-03T17:00:00,ITA,1,Piemonte,45.0732745,7.680687483,4459,366,4825,65181,70006,2230,96473,6452,172931,982816
5957,2020-12-03T17:00:00,ITA,16,Puglia,41.12559576,16.86736689,1621,226,1847,39902,41749,1602,15912,1588,59249,555325
5958,2020-12-03T17:00:00,ITA,20,Sardegna,39.21531192,9.110616306,593,66,659,13561,14220,538,8196,462,22878,323045
5959,2020-12-03T17:00:00,ITA,19,Sicilia,38.11569725,13.3623567,1465,221,1686,38094,39780,1294,26432,1650,67862,674771
5960,2020-12-03T17:00:00,ITA,9,Toscana,43.76923077,11.25588885,1467,272,1739,33691,35430,929,67618,2756,105804,971080
5961,2020-12-03T17:00:00,ITA,10,Umbria,43.10675841,12.38824698,344,54,398,6364,6762,286,17314,440,24516,228438
5962,2020-12-03T17:00:00,ITA,2,Valle d'Aosta,45.73750286,7.320149366,113,11,124,994,1118,42,5177,324,6619,34276
5963,2020-12-03T17:00:00,ITA,5,Veneto,45.43490485,12.33845213,2501,307,2808,67795,70603,3581,79905,3982,154490,1077351
5964,2020-12-04T17:00:00,ITA,13,Abruzzo,42.35122196,13.39843823,700,73,773,17019,17792,408,10857,955,29604,243415
5965,2020-12-04T17:00:00,ITA,17,Basilicata,40.63947052,15.80514834,165,20,185,6259,6444,142,2123,161,8728,157503
5966,2020-12-04T17:00:00,ITA,18,Calabria,38.90597598,16.59440194,390,34,424,10151,10575,335,6987,329,17891,364826
5967,2020-12-04T17:00:00,ITA,15,Campania,40.83956555,14.25084984,1999,166,2165,99691,101856,1651,58461,1903,162220,1132418
5968,2020-12-04T17:00:00,ITA,8,Emilia-Romagna,44.49436681,11.3417208,2717,248,2965,67091,70056,2143,53931,6022,130009,1103704
5969,2020-12-04T17:00:00,ITA,6,Friuli Venezia Giulia,45.6494354,13.76813649,632,59,691,14482,15173,1040,17860,977,34010,293200
5970,2020-12-04T17:00:00,ITA,12,Lazio,41.89277044,12.48366722,3178,360,3538,90299,93837,1831,30427,2576,126840,1852335
5971,2020-12-04T17:00:00,ITA,7,Liguria,44.41149315,8.9326992,912,99,1011,10016,11027,367,39660,2474,53161,296122
5972,2020-12-04T17:00:00,ITA,3,Lombardia,45.46679409,9.190347404,6792,822,7614,109088,116702,4533,284073,22773,423548,2397885
5973,2020-12-04T17:00:00,ITA,11,Marche,43.61675973,13.5188753,518,87,605,18756,19361,492,10866,1305,31532,247137
5974,2020-12-04T17:00:00,ITA,14,Molise,41.55774754,14.65916051,64,10,74,2531,2605,176,2364,129,5098,88626
5975,2020-12-04T17:00:00,ITA,21,P.A. Bolzano,46.49933453,11.35662422,418,32,450,10736,11186,285,13092,569,24847,151045
5976,2020-12-04T17:00:00,ITA,22,P.A. Trento,46.06893511,11.12123097,415,47,462,2044,2506,255,13475,680,16661,139155
5977,2020-12-04T17:00:00,ITA,1,Piemonte,45.0732745,7.680687483,4351,357,4708,63768,68476,2132,100081,6506,175063,990479
5978,2020-12-04T17:00:00,ITA,16,Puglia,41.12559576,16.86736689,1596,227,1823,40721,42544,1419,16464,1660,60668,561954
5979,2020-12-04T17:00:00,ITA,20,Sardegna,39.21531192,9.110616306,591,70,661,13840,14501,551,8417,511,23429,327023
5980,2020-12-04T17:00:00,ITA,19,Sicilia,38.11569725,13.3623567,1431,216,1647,37703,39350,1365,28188,1689,69227,680641
5981,2020-12-04T17:00:00,ITA,9,Toscana,43.76923077,11.25588885,1418,263,1681,31598,33279,1071,70798,2798,106875,975232
5982,2020-12-04T17:00:00,ITA,10,Umbria,43.10675841,12.38824698,327,57,384,6039,6423,168,17817,444,24684,229396
5983,2020-12-04T17:00:00,ITA,2,Valle d'Aosta,45.73750286,7.320149366,109,11,120,960,1080,27,5240,326,6646,34374
5984,2020-12-04T17:00:00,ITA,5,Veneto,45.43490485,12.33845213,2477,309,2786,70143,72929,3708,81204,4065,158198,1081598
5985,2020-12-05T17:00:00,ITA,13,Abruzzo,42.35122196,13.39843823,675,73,748,16499,17247,376,11764,969,29980,245073
5986,2020-12-05T17:00:00,ITA,17,Basilicata,40.63947052,15.80514834,134,19,153,6259,6412,131,2278,169,8859,158895
5987,2020-12-05T17:00:00,ITA,18,Calabria,38.90597598,16.59440194,379,29,408,10254,10662,306,7196,339,18197,367635
5988,2020-12-05T17:00:00,ITA,15,Campania,40.83956555,14.25084984,1558,165,1723,99638,101361,1521,60422,1958,163741,1144454
5989,2020-12-05T17:00:00,ITA,8,Emilia-Romagna,44.49436681,11.3417208,2707,243,2950,66679,69629,1964,56270,6074,131973,1109844
5990,2020-12-05T17:00:00,ITA,6,Friuli Venezia Giulia,45.6494354,13.76813649,640,58,698,14366,15064,755,18693,1008,34765,295536
5991,2020-12-05T17:00:00,ITA,12,Lazio,41.89277044,12.48366722,3075,349,3424,90055,93479,1783,32536,2608,128623,1867721
5992,2020-12-05T17:00:00,ITA,7,Liguria,44.41149315,8.9326992,897,93,990,9528,10518,314,40456,2501,53475,297122
5993,2020-12-05T17:00:00,ITA,3,Lombardia,45.46679409,9.190347404,6554,805,7359,108397,115756,3148,288056,22884,426696,2407249
5994,2020-12-05T17:00:00,ITA,11,Marche,43.61675973,13.5188753,506,84,590,19108,19698,418,10938,1314,31950,250652
5995,2020-12-05T17:00:00,ITA,14,Molise,41.55774754,14.65916051,61,9,70,2615,2685,152,2432,133,5250,89725
5996,2020-12-05T17:00:00,ITA,21,P.A. Bolzano,46.49933453,11.35662422,410,31,441,10671,11112,266,13429,572,25113,151590
5997,2020-12-05T17:00:00,ITA,22,P.A. Trento,46.06893511,11.12123097,404,48,452,2067,2519,226,13679,689,16887,140064
5998,2020-12-05T17:00:00,ITA,1,Piemonte,45.0732745,7.680687483,4276,366,4642,62121,66763,1456,103188,6568,176519,996658
5999,2020-12-05T17:00:00,ITA,16,Puglia,41.12559576,16.86736689,1576,220,1796,42364,44160,1884,16704,1688,62552,565942
6000,2020-12-05T17:00:00,ITA,20,Sardegna,39.21531192,9.110616306,607,67,674,14183,14857,464,8512,524,23893,329682
6001,2020-12-05T17:00:00,ITA,19,Sicilia,38.11569725,13.3623567,1400,215,1615,37925,39540,1240,29204,1723,70467,687039
6002,2020-12-05T17:00:00,ITA,9,Toscana,43.76923077,11.25588885,1373,261,1634,28910,30544,769,74261,2839,107644,979295
6003,2020-12-05T17:00:00,ITA,10,Umbria,43.10675841,12.38824698,330,61,391,5758,6149,226,18310,451,24910,230476
6004,2020-12-05T17:00:00,ITA,2,Valle d'Aosta,45.73750286,7.320149366,107,9,116,940,1056,46,5306,330,6692,34511
6005,2020-12-05T17:00:00,ITA,5,Veneto,45.43490485,12.33845213,2489,312,2801,72157,74958,3607,82674,4173,161805,1086461
6006,2020-12-06T17:00:00,ITA,13,Abruzzo,42.35122196,13.39843823,667,71,738,16350,17088,294,12206,980,30274,246492
6007,2020-12-06T17:00:00,ITA,17,Basilicata,40.63947052,15.80514834,119,18,137,6231,6368,81,2397,175,8940,160485
6008,2020-12-06T17:00:00,ITA,18,Calabria,38.90597598,16.59440194,390,32,422,10239,10661,340,7533,343,18537,370059
6009,2020-12-06T17:00:00,ITA,15,Campania,40.83956555,14.25084984,1916,155,2071,99172,101243,1552,62060,1990,165293,1153658
6010,2020-12-06T17:00:00,ITA,8,Emilia-Romagna,44.49436681,11.3417208,2736,241,2977,65190,68167,1788,59432,6162,133761,1115823
6011,2020-12-06T17:00:00,ITA,6,Friuli Venezia Giulia,45.6494354,13.76813649,652,59,711,14320,15031,702,19401,1035,35467,296752
6012,2020-12-06T17:00:00,ITA,12,Lazio,41.89277044,12.48366722,3136,340,3476,90735,94211,1632,33422,2622,130255,1882721
6013,2020-12-06T17:00:00,ITA,7,Liguria,44.41149315,8.9326992,868,92,960,9456,10416,304,40842,2521,53779,298052
6014,2020-12-06T17:00:00,ITA,3,Lombardia,45.46679409,9.190347404,6372,807,7179,109200,116379,2413,289706,23024,429109,2415099
6015,2020-12-06T17:00:00,ITA,11,Marche,43.61675973,13.5188753,518,82,600,19458,20058,443,11008,1327,32393,253076
6016,2020-12-06T17:00:00,ITA,14,Molise,41.55774754,14.65916051,56,10,66,2647,2713,36,2438,135,5286,90383
6017,2020-12-06T17:00:00,ITA,21,P.A. Bolzano,46.49933453,11.35662422,410,32,442,10479,10921,248,13862,578,25361,152109
6018,2020-12-06T17:00:00,ITA,22,P.A. Trento,46.06893511,11.12123097,414,48,462,1955,2417,216,13995,691,17103,141146
6019,2020-12-06T17:00:00,ITA,1,Piemonte,45.0732745,7.680687483,4239,359,4598,61440,66038,1269,105127,6623,177788,1000611
6020,2020-12-06T17:00:00,ITA,16,Puglia,41.12559576,16.86736689,1613,203,1816,44018,45834,1789,16795,1712,64341,567857
6021,2020-12-06T17:00:00,ITA,20,Sardegna,39.21531192,9.110616306,616,64,680,14280,14960,293,8695,531,24186,333552
6022,2020-12-06T17:00:00,ITA,19,Sicilia,38.11569725,13.3623567,1367,213,1580,38166,39746,1022,29984,1759,71489,692062
6023,2020-12-06T17:00:00,ITA,9,Toscana,43.76923077,11.25588885,1360,252,1612,27587,29199,753,76331,2867,108397,983103
6024,2020-12-06T17:00:00,ITA,10,Umbria,43.10675841,12.38824698,332,60,392,5673,6065,234,18619,460,25144,231538
6025,2020-12-06T17:00:00,ITA,2,Valle d'Aosta,45.73750286,7.320149366,102,8,110,877,987,34,5406,333,6726,34644
6026,2020-12-06T17:00:00,ITA,5,Veneto,45.43490485,12.33845213,2508,308,2816,73988,76804,3444,84235,4210,165249,1090932
